lesion_name,dataset_id,dataset_name,p,r,tp,fp,fn,volume,pred_volume
ULSDL3D_000042_03_01_043_lesion_01.nii.gz,1,ct,0.0,0.0,0,1119,494,494.0,1119
ULSDL3D_000042_03_01_043_lesion_01.nii.gz,2,ct+seg,0.215,0.609,301,1099,193,494.0,1400
ULSDL3D_000042_03_01_043_lesion_01.nii.gz,3,ct+seg+box,0.729,0.791,391,145,103,494.0,536
ULSDL3D_000042_03_01_043_lesion_01.nii.gz,5,ct+seg+2box,0.723,0.931,460,176,34,494.0,636
ULSDL3D_000042_03_01_043_lesion_01.nii.gz,6,ct+seg+mask,0.769,0.741,366,110,128,494.0,476
ULSDL3D_000042_03_01_043_lesion_01.nii.gz,7,ct+seg+2mask,0.867,0.96,474,73,20,494.0,547
ULSDL3D_000090_01_01_115_lesion_01.nii.gz,1,ct,0.0,0.0,0,1112,173,173.0,1112
ULSDL3D_000090_01_01_115_lesion_01.nii.gz,2,ct+seg,0.648,0.595,103,56,70,173.0,159
ULSDL3D_000090_01_01_115_lesion_01.nii.gz,3,ct+seg+box,0.56,0.948,164,129,9,173.0,293
ULSDL3D_000090_01_01_115_lesion_01.nii.gz,5,ct+seg+2box,0.771,0.855,148,44,25,173.0,192
ULSDL3D_000090_01_01_115_lesion_01.nii.gz,6,ct+seg+mask,0.584,0.867,150,107,23,173.0,257
ULSDL3D_000090_01_01_115_lesion_01.nii.gz,7,ct+seg+2mask,0.827,0.665,115,24,58,173.0,139
ULSDL3D_000091_03_01_058_lesion_01.nii.gz,1,ct,0.0,0.0,0,2279,159,159.0,2279
ULSDL3D_000091_03_01_058_lesion_01.nii.gz,2,ct+seg,0.13,0.881,140,933,19,159.0,1073
ULSDL3D_000091_03_01_058_lesion_01.nii.gz,3,ct+seg+box,0.613,0.836,133,84,26,159.0,217
ULSDL3D_000091_03_01_058_lesion_01.nii.gz,5,ct+seg+2box,0.847,0.73,116,21,43,159.0,137
ULSDL3D_000091_03_01_058_lesion_01.nii.gz,6,ct+seg+mask,0.616,0.868,138,86,21,159.0,224
ULSDL3D_000091_03_01_058_lesion_01.nii.gz,7,ct+seg+2mask,0.966,0.711,113,4,46,159.0,117
ULSDL3D_000103_13_01_019_lesion_01.nii.gz,1,ct,0.649,0.947,323,175,18,341.0,498
ULSDL3D_000103_13_01_019_lesion_01.nii.gz,2,ct+seg,0.763,0.915,312,97,29,341.0,409
ULSDL3D_000103_13_01_019_lesion_01.nii.gz,3,ct+seg+box,0.847,0.748,255,46,86,341.0,301
ULSDL3D_000103_13_01_019_lesion_01.nii.gz,5,ct+seg+2box,0.723,0.88,300,115,41,341.0,415
ULSDL3D_000103_13_01_019_lesion_01.nii.gz,6,ct+seg+mask,0.895,0.777,265,31,76,341.0,296
ULSDL3D_000103_13_01_019_lesion_01.nii.gz,7,ct+seg+2mask,0.921,0.891,304,26,37,341.0,330
ULSDL3D_000116_07_02_163_lesion_01.nii.gz,1,ct,0.0,0.0,0,495,76,76.0,495
ULSDL3D_000116_07_02_163_lesion_01.nii.gz,2,ct+seg,0.0,0.0,0,411,76,76.0,411
ULSDL3D_000116_07_02_163_lesion_01.nii.gz,3,ct+seg+box,0.0,0.0,0,0,76,76.0,0
ULSDL3D_000116_07_02_163_lesion_01.nii.gz,5,ct+seg+2box,0.789,0.737,56,15,20,76.0,71
ULSDL3D_000116_07_02_163_lesion_01.nii.gz,6,ct+seg+mask,0.0,0.0,0,652,76,76.0,652
ULSDL3D_000116_07_02_163_lesion_01.nii.gz,7,ct+seg+2mask,0.836,0.605,46,9,30,76.0,55
ULSDL3D_000117_03_01_040_lesion_01.nii.gz,1,ct,0.0,0.0,0,447,120,120.0,447
ULSDL3D_000117_03_01_040_lesion_01.nii.gz,2,ct+seg,0.137,0.675,81,509,39,120.0,590
ULSDL3D_000117_03_01_040_lesion_01.nii.gz,3,ct+seg+box,0.456,0.917,110,131,10,120.0,241
ULSDL3D_000117_03_01_040_lesion_01.nii.gz,5,ct+seg+2box,0.82,0.908,109,24,11,120.0,133
ULSDL3D_000117_03_01_040_lesion_01.nii.gz,6,ct+seg+mask,0.67,1.0,120,59,0,120.0,179
ULSDL3D_000117_03_01_040_lesion_01.nii.gz,7,ct+seg+2mask,1.0,0.992,119,0,1,120.0,119
ULSDL3D_000136_02_01_024_lesion_01.nii.gz,1,ct,0.029,0.026,8,267,305,313.0,275
ULSDL3D_000136_02_01_024_lesion_01.nii.gz,2,ct+seg,0.751,0.703,220,73,93,313.0,293
ULSDL3D_000136_02_01_024_lesion_01.nii.gz,3,ct+seg+box,0.63,0.815,255,150,58,313.0,405
ULSDL3D_000136_02_01_024_lesion_01.nii.gz,5,ct+seg+2box,0.962,0.802,251,10,62,313.0,261
ULSDL3D_000136_02_01_024_lesion_01.nii.gz,6,ct+seg+mask,0.724,0.863,270,103,43,313.0,373
ULSDL3D_000136_02_01_024_lesion_01.nii.gz,7,ct+seg+2mask,0.996,0.869,272,1,41,313.0,273
ULSDL3D_000148_06_01_034_lesion_01.nii.gz,1,ct,0.0,0.0,0,58,134,134.0,58
ULSDL3D_000148_06_01_034_lesion_01.nii.gz,2,ct+seg,0.046,0.478,64,1334,70,134.0,1398
ULSDL3D_000148_06_01_034_lesion_01.nii.gz,3,ct+seg+box,0.942,0.604,81,5,53,134.0,86
ULSDL3D_000148_06_01_034_lesion_01.nii.gz,5,ct+seg+2box,0.901,0.746,100,11,34,134.0,111
ULSDL3D_000148_06_01_034_lesion_01.nii.gz,6,ct+seg+mask,0.866,0.53,71,11,63,134.0,82
ULSDL3D_000148_06_01_034_lesion_01.nii.gz,7,ct+seg+2mask,0.963,0.776,104,4,30,134.0,108
ULSDL3D_000156_02_01_037_lesion_01.nii.gz,1,ct,0.0,0.0,0,945,169,169.0,945
ULSDL3D_000156_02_01_037_lesion_01.nii.gz,2,ct+seg,0.579,0.799,135,98,34,169.0,233
ULSDL3D_000156_02_01_037_lesion_01.nii.gz,3,ct+seg+box,0.718,0.935,158,62,11,169.0,220
ULSDL3D_000156_02_01_037_lesion_01.nii.gz,5,ct+seg+2box,0.75,0.852,144,48,25,169.0,192
ULSDL3D_000156_02_01_037_lesion_01.nii.gz,6,ct+seg+mask,0.782,0.828,140,39,29,169.0,179
ULSDL3D_000156_02_01_037_lesion_01.nii.gz,7,ct+seg+2mask,0.935,0.68,115,8,54,169.0,123
ULSDL3D_000167_02_01_030_lesion_01.nii.gz,1,ct,0.0,0.0,0,75,617,617.0,75
ULSDL3D_000167_02_01_030_lesion_01.nii.gz,2,ct+seg,0.939,0.572,353,23,264,617.0,376
ULSDL3D_000167_02_01_030_lesion_01.nii.gz,3,ct+seg+box,0.919,0.703,434,38,183,617.0,472
ULSDL3D_000167_02_01_030_lesion_01.nii.gz,5,ct+seg+2box,0.88,0.783,483,66,134,617.0,549
ULSDL3D_000167_02_01_030_lesion_01.nii.gz,6,ct+seg+mask,0.863,0.768,474,75,143,617.0,549
ULSDL3D_000167_02_01_030_lesion_01.nii.gz,7,ct+seg+2mask,0.939,0.875,540,35,77,617.0,575
ULSDL3D_000205_01_02_173_lesion_01.nii.gz,1,ct,0.0,0.0,0,2683,2771,2771.0,2683
ULSDL3D_000205_01_02_173_lesion_01.nii.gz,2,ct+seg,0.037,0.005,14,364,2757,2771.0,378
ULSDL3D_000205_01_02_173_lesion_01.nii.gz,3,ct+seg+box,0.732,0.719,1992,728,779,2771.0,2720
ULSDL3D_000205_01_02_173_lesion_01.nii.gz,5,ct+seg+2box,0.85,0.821,2275,403,496,2771.0,2678
ULSDL3D_000205_01_02_173_lesion_01.nii.gz,6,ct+seg+mask,0.746,0.72,1995,678,776,2771.0,2673
ULSDL3D_000205_01_02_173_lesion_01.nii.gz,7,ct+seg+2mask,0.924,0.822,2279,188,492,2771.0,2467
ULSDL3D_000224_04_02_143_lesion_01.nii.gz,1,ct,0.503,0.807,1230,1217,294,1524.0,2447
ULSDL3D_000224_04_02_143_lesion_01.nii.gz,2,ct+seg,0.265,0.599,913,2536,611,1524.0,3449
ULSDL3D_000224_04_02_143_lesion_01.nii.gz,3,ct+seg+box,0.0,0.0,0,0,1524,1524.0,0
ULSDL3D_000224_04_02_143_lesion_01.nii.gz,5,ct+seg+2box,0.691,0.869,1324,592,200,1524.0,1916
ULSDL3D_000224_04_02_143_lesion_01.nii.gz,6,ct+seg+mask,0.489,0.551,840,879,684,1524.0,1719
ULSDL3D_000224_04_02_143_lesion_01.nii.gz,7,ct+seg+2mask,0.88,0.788,1201,163,323,1524.0,1364
ULSDL3D_000228_03_02_067_lesion_01.nii.gz,1,ct,0.0,0.0,0,486,373,373.0,486
ULSDL3D_000228_03_02_067_lesion_01.nii.gz,2,ct+seg,0.363,0.831,310,543,63,373.0,853
ULSDL3D_000228_03_02_067_lesion_01.nii.gz,3,ct+seg+box,0.687,0.654,244,111,129,373.0,355
ULSDL3D_000228_03_02_067_lesion_01.nii.gz,5,ct+seg+2box,0.784,0.874,326,90,47,373.0,416
ULSDL3D_000228_03_02_067_lesion_01.nii.gz,6,ct+seg+mask,0.631,0.651,243,142,130,373.0,385
ULSDL3D_000228_03_02_067_lesion_01.nii.gz,7,ct+seg+2mask,0.963,0.906,338,13,35,373.0,351
ULSDL3D_000237_02_01_056_lesion_01.nii.gz,1,ct,0.0,0.0,0,31,98,98.0,31
ULSDL3D_000237_02_01_056_lesion_01.nii.gz,2,ct+seg,0.745,0.388,38,13,60,98.0,51
ULSDL3D_000237_02_01_056_lesion_01.nii.gz,3,ct+seg+box,0.932,0.704,69,5,29,98.0,74
ULSDL3D_000237_02_01_056_lesion_01.nii.gz,5,ct+seg+2box,0.955,0.857,84,4,14,98.0,88
ULSDL3D_000237_02_01_056_lesion_01.nii.gz,6,ct+seg+mask,1.0,0.622,61,0,37,98.0,61
ULSDL3D_000237_02_01_056_lesion_01.nii.gz,7,ct+seg+2mask,1.0,0.857,84,0,14,98.0,84
ULSDL3D_000251_12_02_491_lesion_01.nii.gz,1,ct,0.032,0.128,151,4627,1028,1179.0,4778
ULSDL3D_000251_12_02_491_lesion_01.nii.gz,2,ct+seg,0.233,0.513,605,1991,574,1179.0,2596
ULSDL3D_000251_12_02_491_lesion_01.nii.gz,3,ct+seg+box,0.607,0.781,921,597,258,1179.0,1518
ULSDL3D_000251_12_02_491_lesion_01.nii.gz,5,ct+seg+2box,0.926,0.437,515,41,664,1179.0,556
ULSDL3D_000251_12_02_491_lesion_01.nii.gz,6,ct+seg+mask,0.585,0.848,1000,708,179,1179.0,1708
ULSDL3D_000251_12_02_491_lesion_01.nii.gz,7,ct+seg+2mask,0.957,0.45,531,24,648,1179.0,555
ULSDL3D_000260_11_01_109_lesion_01.nii.gz,1,ct,0.778,0.875,488,139,70,558.0,627
ULSDL3D_000260_11_01_109_lesion_01.nii.gz,2,ct+seg,0.622,0.93,519,316,39,558.0,835
ULSDL3D_000260_11_01_109_lesion_01.nii.gz,3,ct+seg+box,0.991,0.577,322,3,236,558.0,325
ULSDL3D_000260_11_01_109_lesion_01.nii.gz,5,ct+seg+2box,0.972,0.695,388,11,170,558.0,399
ULSDL3D_000260_11_01_109_lesion_01.nii.gz,6,ct+seg+mask,0.916,0.624,348,32,210,558.0,380
ULSDL3D_000260_11_01_109_lesion_01.nii.gz,7,ct+seg+2mask,0.973,0.855,477,13,81,558.0,490
ULSDL3D_000294_01_01_118_lesion_01.nii.gz,1,ct,0.003,0.0,1,345,2107,2108.0,346
ULSDL3D_000294_01_01_118_lesion_01.nii.gz,2,ct+seg,0.418,0.662,1395,1946,713,2108.0,3341
ULSDL3D_000294_01_01_118_lesion_01.nii.gz,3,ct+seg+box,0.969,0.541,1140,37,968,2108.0,1177
ULSDL3D_000294_01_01_118_lesion_01.nii.gz,5,ct+seg+2box,0.884,0.711,1499,197,609,2108.0,1696
ULSDL3D_000294_01_01_118_lesion_01.nii.gz,6,ct+seg+mask,0.896,0.489,1030,119,1078,2108.0,1149
ULSDL3D_000294_01_01_118_lesion_01.nii.gz,7,ct+seg+2mask,0.943,0.774,1632,98,476,2108.0,1730
ULSDL3D_000306_04_01_023_lesion_01.nii.gz,1,ct,0.485,0.555,198,210,159,357.0,408
ULSDL3D_000306_04_01_023_lesion_01.nii.gz,2,ct+seg,0.965,0.611,218,8,139,357.0,226
ULSDL3D_000306_04_01_023_lesion_01.nii.gz,3,ct+seg+box,0.949,0.627,224,12,133,357.0,236
ULSDL3D_000306_04_01_023_lesion_01.nii.gz,5,ct+seg+2box,0.713,0.854,305,123,52,357.0,428
ULSDL3D_000306_04_01_023_lesion_01.nii.gz,6,ct+seg+mask,0.819,0.661,236,52,121,357.0,288
ULSDL3D_000306_04_01_023_lesion_01.nii.gz,7,ct+seg+2mask,0.928,0.905,323,25,34,357.0,348
ULSDL3D_000306_06_01_027_lesion_01.nii.gz,1,ct,0.793,0.903,241,63,26,267.0,304
ULSDL3D_000306_06_01_027_lesion_01.nii.gz,2,ct+seg,0.908,0.888,237,24,30,267.0,261
ULSDL3D_000306_06_01_027_lesion_01.nii.gz,3,ct+seg+box,0.843,0.843,225,42,42,267.0,267
ULSDL3D_000306_06_01_027_lesion_01.nii.gz,5,ct+seg+2box,0.791,0.88,235,62,32,267.0,297
ULSDL3D_000306_06_01_027_lesion_01.nii.gz,6,ct+seg+mask,0.878,0.783,209,29,58,267.0,238
ULSDL3D_000306_06_01_027_lesion_01.nii.gz,7,ct+seg+2mask,0.945,0.899,240,14,27,267.0,254
ULSDL3D_000306_07_01_181_lesion_01.nii.gz,1,ct,0.268,0.851,595,1623,104,699.0,2218
ULSDL3D_000306_07_01_181_lesion_01.nii.gz,2,ct+seg,0.838,0.807,564,109,135,699.0,673
ULSDL3D_000306_07_01_181_lesion_01.nii.gz,3,ct+seg+box,0.0,0.0,0,0,699,699.0,0
ULSDL3D_000306_07_01_181_lesion_01.nii.gz,5,ct+seg+2box,0.984,0.69,482,8,217,699.0,490
ULSDL3D_000306_07_01_181_lesion_01.nii.gz,6,ct+seg+mask,0.201,0.528,369,1466,330,699.0,1835
ULSDL3D_000306_07_01_181_lesion_01.nii.gz,7,ct+seg+2mask,0.996,0.667,466,2,233,699.0,468
ULSDL3D_000312_02_01_033_lesion_01.nii.gz,1,ct,0.0,0.0,0,158,236,236.0,158
ULSDL3D_000312_02_01_033_lesion_01.nii.gz,2,ct+seg,0.144,0.326,77,456,159,236.0,533
ULSDL3D_000312_02_01_033_lesion_01.nii.gz,3,ct+seg+box,0.627,0.669,158,94,78,236.0,252
ULSDL3D_000312_02_01_033_lesion_01.nii.gz,5,ct+seg+2box,0.864,0.729,172,27,64,236.0,199
ULSDL3D_000312_02_01_033_lesion_01.nii.gz,6,ct+seg+mask,0.616,0.686,162,101,74,236.0,263
ULSDL3D_000312_02_01_033_lesion_01.nii.gz,7,ct+seg+2mask,0.936,0.809,191,13,45,236.0,204
ULSDL3D_000332_06_02_264_lesion_01.nii.gz,1,ct,0.066,0.291,58,816,141,199.0,874
ULSDL3D_000332_06_02_264_lesion_01.nii.gz,2,ct+seg,0.0,0.0,0,302,199,199.0,302
ULSDL3D_000332_06_02_264_lesion_01.nii.gz,3,ct+seg+box,0.0,0.0,0,0,199,199.0,0
ULSDL3D_000332_06_02_264_lesion_01.nii.gz,5,ct+seg+2box,0.929,0.327,65,5,134,199.0,70
ULSDL3D_000332_06_02_264_lesion_01.nii.gz,6,ct+seg+mask,0.0,0.0,0,149,199,199.0,149
ULSDL3D_000332_06_02_264_lesion_01.nii.gz,7,ct+seg+2mask,0.94,0.392,78,5,121,199.0,83
ULSDL3D_000336_01_01_006_lesion_01.nii.gz,1,ct,0.291,0.237,67,163,216,283.0,230
ULSDL3D_000336_01_01_006_lesion_01.nii.gz,2,ct+seg,0.509,0.594,168,162,115,283.0,330
ULSDL3D_000336_01_01_006_lesion_01.nii.gz,3,ct+seg+box,0.847,0.509,144,26,139,283.0,170
ULSDL3D_000336_01_01_006_lesion_01.nii.gz,5,ct+seg+2box,0.874,0.615,174,25,109,283.0,199
ULSDL3D_000336_01_01_006_lesion_01.nii.gz,6,ct+seg+mask,0.821,0.47,133,29,150,283.0,162
ULSDL3D_000336_01_01_006_lesion_01.nii.gz,7,ct+seg+2mask,0.925,0.569,161,13,122,283.0,174
ULSDL3D_000358_03_01_073_lesion_01.nii.gz,1,ct,0.0,0.0,0,325,205,205.0,325
ULSDL3D_000358_03_01_073_lesion_01.nii.gz,2,ct+seg,0.342,0.8,164,315,41,205.0,479
ULSDL3D_000358_03_01_073_lesion_01.nii.gz,3,ct+seg+box,0.864,0.527,108,17,97,205.0,125
ULSDL3D_000358_03_01_073_lesion_01.nii.gz,5,ct+seg+2box,0.734,0.766,157,57,48,205.0,214
ULSDL3D_000358_03_01_073_lesion_01.nii.gz,6,ct+seg+mask,0.93,0.454,93,7,112,205.0,100
ULSDL3D_000358_03_01_073_lesion_01.nii.gz,7,ct+seg+2mask,0.864,0.683,140,22,65,205.0,162
ULSDL3D_000360_01_01_028_lesion_01.nii.gz,1,ct,0.0,0.0,0,176,276,276.0,176
ULSDL3D_000360_01_01_028_lesion_01.nii.gz,2,ct+seg,0.239,0.438,121,385,155,276.0,506
ULSDL3D_000360_01_01_028_lesion_01.nii.gz,3,ct+seg+box,0.783,0.851,235,65,41,276.0,300
ULSDL3D_000360_01_01_028_lesion_01.nii.gz,5,ct+seg+2box,0.826,0.841,232,49,44,276.0,281
ULSDL3D_000360_01_01_028_lesion_01.nii.gz,6,ct+seg+mask,0.875,0.815,225,32,51,276.0,257
ULSDL3D_000360_01_01_028_lesion_01.nii.gz,7,ct+seg+2mask,0.932,0.797,220,16,56,276.0,236
ULSDL3D_000372_05_01_301_lesion_01.nii.gz,1,ct,0.0,0.0,0,2753,846,846.0,2753
ULSDL3D_000372_05_01_301_lesion_01.nii.gz,2,ct+seg,0.929,0.774,655,50,191,846.0,705
ULSDL3D_000372_05_01_301_lesion_01.nii.gz,3,ct+seg+box,0.826,0.573,485,102,361,846.0,587
ULSDL3D_000372_05_01_301_lesion_01.nii.gz,5,ct+seg+2box,0.869,0.704,596,90,250,846.0,686
ULSDL3D_000372_05_01_301_lesion_01.nii.gz,6,ct+seg+mask,0.82,0.677,573,126,273,846.0,699
ULSDL3D_000372_05_01_301_lesion_01.nii.gz,7,ct+seg+2mask,0.955,0.651,551,26,295,846.0,577
ULSDL3D_000388_08_03_179_lesion_01.nii.gz,1,ct,0.155,0.877,121,662,17,138.0,783
ULSDL3D_000388_08_03_179_lesion_01.nii.gz,2,ct+seg,1.0,0.022,3,0,135,138.0,3
ULSDL3D_000388_08_03_179_lesion_01.nii.gz,3,ct+seg+box,0.71,0.514,71,29,67,138.0,100
ULSDL3D_000388_08_03_179_lesion_01.nii.gz,5,ct+seg+2box,0.701,0.493,68,29,70,138.0,97
ULSDL3D_000388_08_03_179_lesion_01.nii.gz,6,ct+seg+mask,0.67,0.514,71,35,67,138.0,106
ULSDL3D_000388_08_03_179_lesion_01.nii.gz,7,ct+seg+2mask,0.743,0.399,55,19,83,138.0,74
ULSDL3D_000426_02_01_093_lesion_01.nii.gz,1,ct,0.0,0.0,0,99,2527,2527.0,99
ULSDL3D_000426_02_01_093_lesion_01.nii.gz,2,ct+seg,0.084,0.066,167,1828,2360,2527.0,1995
ULSDL3D_000426_02_01_093_lesion_01.nii.gz,3,ct+seg+box,0.948,0.267,675,37,1852,2527.0,712
ULSDL3D_000426_02_01_093_lesion_01.nii.gz,5,ct+seg+2box,0.859,0.76,1920,316,607,2527.0,2236
ULSDL3D_000426_02_01_093_lesion_01.nii.gz,6,ct+seg+mask,0.962,0.281,709,28,1818,2527.0,737
ULSDL3D_000426_02_01_093_lesion_01.nii.gz,7,ct+seg+2mask,0.915,0.853,2155,199,372,2527.0,2354
ULSDL3D_000441_02_01_187_lesion_01.nii.gz,1,ct,0.367,0.734,669,1155,243,912.0,1824
ULSDL3D_000441_02_01_187_lesion_01.nii.gz,2,ct+seg,0.879,0.73,666,92,246,912.0,758
ULSDL3D_000441_02_01_187_lesion_01.nii.gz,3,ct+seg+box,0.928,0.562,513,40,399,912.0,553
ULSDL3D_000441_02_01_187_lesion_01.nii.gz,5,ct+seg+2box,0.97,0.598,545,17,367,912.0,562
ULSDL3D_000441_02_01_187_lesion_01.nii.gz,6,ct+seg+mask,0.946,0.673,614,35,298,912.0,649
ULSDL3D_000441_02_01_187_lesion_01.nii.gz,7,ct+seg+2mask,0.948,0.663,605,33,307,912.0,638
ULSDL3D_000445_06_01_053_lesion_01.nii.gz,1,ct,0.0,0.0,0,711,1853,1853.0,711
ULSDL3D_000445_06_01_053_lesion_01.nii.gz,2,ct+seg,0.298,0.052,97,228,1756,1853.0,325
ULSDL3D_000445_06_01_053_lesion_01.nii.gz,3,ct+seg+box,0.661,0.872,1615,828,238,1853.0,2443
ULSDL3D_000445_06_01_053_lesion_01.nii.gz,5,ct+seg+2box,0.942,0.795,1473,90,380,1853.0,1563
ULSDL3D_000445_06_01_053_lesion_01.nii.gz,6,ct+seg+mask,0.594,0.959,1777,1216,76,1853.0,2993
ULSDL3D_000445_06_01_053_lesion_01.nii.gz,7,ct+seg+2mask,0.963,0.859,1592,61,261,1853.0,1653
ULSDL3D_000453_04_02_496_lesion_01.nii.gz,1,ct,0.285,0.494,306,768,313,619.0,1074
ULSDL3D_000453_04_02_496_lesion_01.nii.gz,2,ct+seg,0.0,0.0,0,1891,619,619.0,1891
ULSDL3D_000453_04_02_496_lesion_01.nii.gz,3,ct+seg+box,0.744,0.698,432,149,187,619.0,581
ULSDL3D_000453_04_02_496_lesion_01.nii.gz,5,ct+seg+2box,0.74,0.8,495,174,124,619.0,669
ULSDL3D_000453_04_02_496_lesion_01.nii.gz,6,ct+seg+mask,0.801,0.625,387,96,232,619.0,483
ULSDL3D_000453_04_02_496_lesion_01.nii.gz,7,ct+seg+2mask,0.901,0.68,421,46,198,619.0,467
ULSDL3D_000460_05_01_069_lesion_01.nii.gz,1,ct,0.323,0.841,227,476,43,270.0,703
ULSDL3D_000460_05_01_069_lesion_01.nii.gz,2,ct+seg,0.441,0.819,221,280,49,270.0,501
ULSDL3D_000460_05_01_069_lesion_01.nii.gz,3,ct+seg+box,0.855,0.893,241,41,29,270.0,282
ULSDL3D_000460_05_01_069_lesion_01.nii.gz,5,ct+seg+2box,0.821,0.937,253,55,17,270.0,308
ULSDL3D_000460_05_01_069_lesion_01.nii.gz,6,ct+seg+mask,0.888,0.848,229,29,41,270.0,258
ULSDL3D_000460_05_01_069_lesion_01.nii.gz,7,ct+seg+2mask,0.94,0.926,250,16,20,270.0,266
ULSDL3D_000489_06_01_070_lesion_01.nii.gz,1,ct,0.269,0.601,86,234,57,143.0,320
ULSDL3D_000489_06_01_070_lesion_01.nii.gz,2,ct+seg,0.956,0.608,87,4,56,143.0,91
ULSDL3D_000489_06_01_070_lesion_01.nii.gz,3,ct+seg+box,1.0,0.35,50,0,93,143.0,50
ULSDL3D_000489_06_01_070_lesion_01.nii.gz,5,ct+seg+2box,0.741,0.881,126,44,17,143.0,170
ULSDL3D_000489_06_01_070_lesion_01.nii.gz,6,ct+seg+mask,1.0,0.385,55,0,88,143.0,55
ULSDL3D_000489_06_01_070_lesion_01.nii.gz,7,ct+seg+2mask,0.861,0.734,105,17,38,143.0,122
ULSDL3D_000491_02_01_054_lesion_01.nii.gz,1,ct,0.0,0.0,0,1420,209,209.0,1420
ULSDL3D_000491_02_01_054_lesion_01.nii.gz,2,ct+seg,0.01,0.344,72,7041,137,209.0,7113
ULSDL3D_000491_02_01_054_lesion_01.nii.gz,3,ct+seg+box,0.728,0.885,185,69,24,209.0,254
ULSDL3D_000491_02_01_054_lesion_01.nii.gz,5,ct+seg+2box,0.769,0.923,193,58,16,209.0,251
ULSDL3D_000491_02_01_054_lesion_01.nii.gz,6,ct+seg+mask,0.752,0.914,191,63,18,209.0,254
ULSDL3D_000491_02_01_054_lesion_01.nii.gz,7,ct+seg+2mask,0.96,0.919,192,8,17,209.0,200
ULSDL3D_000492_01_01_082_lesion_01.nii.gz,1,ct,0.438,0.87,114,146,17,131.0,260
ULSDL3D_000492_01_01_082_lesion_01.nii.gz,2,ct+seg,0.772,0.878,115,34,16,131.0,149
ULSDL3D_000492_01_01_082_lesion_01.nii.gz,3,ct+seg+box,0.731,0.931,122,45,9,131.0,167
ULSDL3D_000492_01_01_082_lesion_01.nii.gz,5,ct+seg+2box,0.85,0.954,125,22,6,131.0,147
ULSDL3D_000492_01_01_082_lesion_01.nii.gz,6,ct+seg+mask,0.839,0.916,120,23,11,131.0,143
ULSDL3D_000492_01_01_082_lesion_01.nii.gz,7,ct+seg+2mask,0.991,0.878,115,1,16,131.0,116
ULSDL3D_000502_02_01_054_lesion_01.nii.gz,1,ct,0.13,0.944,167,1120,10,177.0,1287
ULSDL3D_000502_02_01_054_lesion_01.nii.gz,2,ct+seg,0.0,0.0,0,295,177,177.0,295
ULSDL3D_000502_02_01_054_lesion_01.nii.gz,3,ct+seg+box,0.791,0.729,129,34,48,177.0,163
ULSDL3D_000502_02_01_054_lesion_01.nii.gz,5,ct+seg+2box,0.913,0.831,147,14,30,177.0,161
ULSDL3D_000502_02_01_054_lesion_01.nii.gz,6,ct+seg+mask,0.667,0.836,148,74,29,177.0,222
ULSDL3D_000502_02_01_054_lesion_01.nii.gz,7,ct+seg+2mask,0.946,0.893,158,9,19,177.0,167
ULSDL3D_000526_03_01_053_lesion_01.nii.gz,1,ct,0.172,0.594,296,1429,202,498.0,1725
ULSDL3D_000526_03_01_053_lesion_01.nii.gz,2,ct+seg,0.176,0.803,400,1872,98,498.0,2272
ULSDL3D_000526_03_01_053_lesion_01.nii.gz,3,ct+seg+box,0.932,0.739,368,27,130,498.0,395
ULSDL3D_000526_03_01_053_lesion_01.nii.gz,5,ct+seg+2box,0.897,0.871,434,50,64,498.0,484
ULSDL3D_000526_03_01_053_lesion_01.nii.gz,6,ct+seg+mask,0.92,0.763,380,33,118,498.0,413
ULSDL3D_000526_03_01_053_lesion_01.nii.gz,7,ct+seg+2mask,0.914,0.936,466,44,32,498.0,510
ULSDL3D_000543_06_01_010_lesion_01.nii.gz,1,ct,0.305,0.538,164,374,141,305.0,538
ULSDL3D_000543_06_01_010_lesion_01.nii.gz,2,ct+seg,0.379,0.77,235,385,70,305.0,620
ULSDL3D_000543_06_01_010_lesion_01.nii.gz,3,ct+seg+box,0.921,0.646,197,17,108,305.0,214
ULSDL3D_000543_06_01_010_lesion_01.nii.gz,5,ct+seg+2box,0.831,0.803,245,50,60,305.0,295
ULSDL3D_000543_06_01_010_lesion_01.nii.gz,6,ct+seg+mask,0.941,0.679,207,13,98,305.0,220
ULSDL3D_000543_06_01_010_lesion_01.nii.gz,7,ct+seg+2mask,0.899,0.813,248,28,57,305.0,276
ULSDL3D_000578_02_01_059_lesion_01.nii.gz,1,ct,0.0,0.0,0,1635,12358,12358.0,1635
ULSDL3D_000578_02_01_059_lesion_01.nii.gz,2,ct+seg,0.268,0.058,714,1952,11644,12358.0,2666
ULSDL3D_000578_02_01_059_lesion_01.nii.gz,3,ct+seg+box,0.695,0.909,11238,4929,1120,12358.0,16167
ULSDL3D_000578_02_01_059_lesion_01.nii.gz,5,ct+seg+2box,0.824,0.857,10592,2270,1766,12358.0,12862
ULSDL3D_000578_02_01_059_lesion_01.nii.gz,6,ct+seg+mask,0.702,0.946,11695,4974,663,12358.0,16669
ULSDL3D_000578_02_01_059_lesion_01.nii.gz,7,ct+seg+2mask,0.896,0.965,11928,1382,430,12358.0,13310
ULSDL3D_000591_03_01_197_lesion_01.nii.gz,1,ct,0.226,0.889,273,935,34,307.0,1208
ULSDL3D_000591_03_01_197_lesion_01.nii.gz,2,ct+seg,0.609,0.844,259,166,48,307.0,425
ULSDL3D_000591_03_01_197_lesion_01.nii.gz,3,ct+seg+box,0.975,0.769,236,6,71,307.0,242
ULSDL3D_000591_03_01_197_lesion_01.nii.gz,5,ct+seg+2box,0.931,0.785,241,18,66,307.0,259
ULSDL3D_000591_03_01_197_lesion_01.nii.gz,6,ct+seg+mask,0.923,0.782,240,20,67,307.0,260
ULSDL3D_000591_03_01_197_lesion_01.nii.gz,7,ct+seg+2mask,0.936,0.765,235,16,72,307.0,251
ULSDL3D_000603_05_01_004_lesion_01.nii.gz,1,ct,0.0,0.0,0,716,470,470.0,716
ULSDL3D_000603_05_01_004_lesion_01.nii.gz,2,ct+seg,0.0,0.0,0,969,470,470.0,969
ULSDL3D_000603_05_01_004_lesion_01.nii.gz,3,ct+seg+box,0.944,0.749,352,21,118,470.0,373
ULSDL3D_000603_05_01_004_lesion_01.nii.gz,5,ct+seg+2box,0.95,0.815,383,20,87,470.0,403
ULSDL3D_000603_05_01_004_lesion_01.nii.gz,6,ct+seg+mask,0.985,0.845,397,6,73,470.0,403
ULSDL3D_000603_05_01_004_lesion_01.nii.gz,7,ct+seg+2mask,0.964,0.909,427,16,43,470.0,443
ULSDL3D_000629_02_02_417_lesion_01.nii.gz,1,ct,0.0,0.0,0,961,7482,7482.0,961
ULSDL3D_000629_02_02_417_lesion_01.nii.gz,2,ct+seg,0.0,0.0,0,376,7482,7482.0,376
ULSDL3D_000629_02_02_417_lesion_01.nii.gz,3,ct+seg+box,0.76,0.511,3825,1207,3657,7482.0,5032
ULSDL3D_000629_02_02_417_lesion_01.nii.gz,5,ct+seg+2box,0.823,0.789,5905,1272,1577,7482.0,7177
ULSDL3D_000629_02_02_417_lesion_01.nii.gz,6,ct+seg+mask,0.904,0.478,3575,378,3907,7482.0,3953
ULSDL3D_000629_02_02_417_lesion_01.nii.gz,7,ct+seg+2mask,0.92,0.779,5829,507,1653,7482.0,6336
ULSDL3D_000630_03_02_146_lesion_01.nii.gz,1,ct,0.926,0.787,1494,120,404,1898.0,1614
ULSDL3D_000630_03_02_146_lesion_01.nii.gz,2,ct+seg,0.99,0.711,1350,14,548,1898.0,1364
ULSDL3D_000630_03_02_146_lesion_01.nii.gz,3,ct+seg+box,0.916,0.499,948,87,950,1898.0,1035
ULSDL3D_000630_03_02_146_lesion_01.nii.gz,5,ct+seg+2box,0.954,0.699,1327,64,571,1898.0,1391
ULSDL3D_000630_03_02_146_lesion_01.nii.gz,6,ct+seg+mask,0.895,0.604,1147,134,751,1898.0,1281
ULSDL3D_000630_03_02_146_lesion_01.nii.gz,7,ct+seg+2mask,0.987,0.659,1250,16,648,1898.0,1266
ULSDL3D_000655_01_01_033_lesion_01.nii.gz,1,ct,0.0,0.0,0,1327,163,163.0,1327
ULSDL3D_000655_01_01_033_lesion_01.nii.gz,2,ct+seg,0.14,0.479,78,478,85,163.0,556
ULSDL3D_000655_01_01_033_lesion_01.nii.gz,3,ct+seg+box,0.593,0.822,134,92,29,163.0,226
ULSDL3D_000655_01_01_033_lesion_01.nii.gz,5,ct+seg+2box,0.794,0.877,143,37,20,163.0,180
ULSDL3D_000655_01_01_033_lesion_01.nii.gz,6,ct+seg+mask,0.663,0.847,138,70,25,163.0,208
ULSDL3D_000655_01_01_033_lesion_01.nii.gz,7,ct+seg+2mask,0.856,0.951,155,26,8,163.0,181
ULSDL3D_000669_02_01_015_lesion_01.nii.gz,1,ct,0.205,0.874,167,646,24,191.0,813
ULSDL3D_000669_02_01_015_lesion_01.nii.gz,2,ct+seg,0.951,0.717,137,7,54,191.0,144
ULSDL3D_000669_02_01_015_lesion_01.nii.gz,3,ct+seg+box,0.933,0.869,166,12,25,191.0,178
ULSDL3D_000669_02_01_015_lesion_01.nii.gz,5,ct+seg+2box,0.844,0.88,168,31,23,191.0,199
ULSDL3D_000669_02_01_015_lesion_01.nii.gz,6,ct+seg+mask,0.841,0.859,164,31,27,191.0,195
ULSDL3D_000669_02_01_015_lesion_01.nii.gz,7,ct+seg+2mask,0.921,0.921,176,15,15,191.0,191
ULSDL3D_000697_01_01_547_lesion_01.nii.gz,1,ct,0.112,0.296,212,1678,504,716.0,1890
ULSDL3D_000697_01_01_547_lesion_01.nii.gz,2,ct+seg,0.988,0.559,400,5,316,716.0,405
ULSDL3D_000697_01_01_547_lesion_01.nii.gz,3,ct+seg+box,0.0,0.0,0,0,716,716.0,0
ULSDL3D_000697_01_01_547_lesion_01.nii.gz,5,ct+seg+2box,0.825,0.552,395,84,321,716.0,479
ULSDL3D_000697_01_01_547_lesion_01.nii.gz,6,ct+seg+mask,0.0,0.0,0,0,716,716.0,0
ULSDL3D_000697_01_01_547_lesion_01.nii.gz,7,ct+seg+2mask,0.971,0.617,442,13,274,716.0,455
ULSDL3D_000709_02_01_377_lesion_01.nii.gz,1,ct,0.0,0.0,0,2772,1294,1294.0,2772
ULSDL3D_000709_02_01_377_lesion_01.nii.gz,2,ct+seg,0.0,0.0,0,211,1294,1294.0,211
ULSDL3D_000709_02_01_377_lesion_01.nii.gz,3,ct+seg+box,0.915,0.591,765,71,529,1294.0,836
ULSDL3D_000709_02_01_377_lesion_01.nii.gz,5,ct+seg+2box,0.886,0.706,914,118,380,1294.0,1032
ULSDL3D_000709_02_01_377_lesion_01.nii.gz,6,ct+seg+mask,0.897,0.652,844,97,450,1294.0,941
ULSDL3D_000709_02_01_377_lesion_01.nii.gz,7,ct+seg+2mask,0.956,0.662,857,39,437,1294.0,896
ULSDL3D_000775_02_01_052_lesion_01.nii.gz,1,ct,0.0,0.0,0,979,189,189.0,979
ULSDL3D_000775_02_01_052_lesion_01.nii.gz,2,ct+seg,0.528,0.646,122,109,67,189.0,231
ULSDL3D_000775_02_01_052_lesion_01.nii.gz,3,ct+seg+box,0.839,0.746,141,27,48,189.0,168
ULSDL3D_000775_02_01_052_lesion_01.nii.gz,5,ct+seg+2box,0.794,0.735,139,36,50,189.0,175
ULSDL3D_000775_02_01_052_lesion_01.nii.gz,6,ct+seg+mask,0.727,0.804,152,57,37,189.0,209
ULSDL3D_000775_02_01_052_lesion_01.nii.gz,7,ct+seg+2mask,0.945,0.725,137,8,52,189.0,145
ULSDL3D_000813_13_01_070_lesion_01.nii.gz,1,ct,0.0,0.0,0,1365,557,557.0,1365
ULSDL3D_000813_13_01_070_lesion_01.nii.gz,2,ct+seg,0.0,0.0,0,5491,557,557.0,5491
ULSDL3D_000813_13_01_070_lesion_01.nii.gz,3,ct+seg+box,0.844,0.797,444,82,113,557.0,526
ULSDL3D_000813_13_01_070_lesion_01.nii.gz,5,ct+seg+2box,0.8,0.86,479,120,78,557.0,599
ULSDL3D_000813_13_01_070_lesion_01.nii.gz,6,ct+seg+mask,0.872,0.907,505,74,52,557.0,579
ULSDL3D_000813_13_01_070_lesion_01.nii.gz,7,ct+seg+2mask,0.865,0.874,487,76,70,557.0,563
ULSDL3D_000819_07_02_292_lesion_01.nii.gz,1,ct,0.414,0.728,281,398,105,386.0,679
ULSDL3D_000819_07_02_292_lesion_01.nii.gz,2,ct+seg,0.728,0.972,375,140,11,386.0,515
ULSDL3D_000819_07_02_292_lesion_01.nii.gz,3,ct+seg+box,0.783,0.516,199,55,187,386.0,254
ULSDL3D_000819_07_02_292_lesion_01.nii.gz,5,ct+seg+2box,0.857,0.837,323,54,63,386.0,377
ULSDL3D_000819_07_02_292_lesion_01.nii.gz,6,ct+seg+mask,0.881,0.557,215,29,171,386.0,244
ULSDL3D_000819_07_02_292_lesion_01.nii.gz,7,ct+seg+2mask,0.946,0.687,265,15,121,386.0,280
ULSDL3D_000826_02_02_503_lesion_01.nii.gz,1,ct,0.246,0.827,825,2531,172,997.0,3356
ULSDL3D_000826_02_02_503_lesion_01.nii.gz,2,ct+seg,0.876,0.664,662,94,335,997.0,756
ULSDL3D_000826_02_02_503_lesion_01.nii.gz,3,ct+seg+box,0.837,0.759,757,147,240,997.0,904
ULSDL3D_000826_02_02_503_lesion_01.nii.gz,5,ct+seg+2box,0.855,0.728,726,123,271,997.0,849
ULSDL3D_000826_02_02_503_lesion_01.nii.gz,6,ct+seg+mask,0.884,0.782,780,102,217,997.0,882
ULSDL3D_000826_02_02_503_lesion_01.nii.gz,7,ct+seg+2mask,0.946,0.68,678,39,319,997.0,717
ULSDL3D_000859_01_01_117_lesion_01.nii.gz,1,ct,0.0,0.0,0,409,18852,18852.0,409
ULSDL3D_000859_01_01_117_lesion_01.nii.gz,2,ct+seg,0.767,0.076,1429,434,17423,18852.0,1863
ULSDL3D_000859_01_01_117_lesion_01.nii.gz,3,ct+seg+box,0.633,0.913,17218,9962,1634,18852.0,27180
ULSDL3D_000859_01_01_117_lesion_01.nii.gz,5,ct+seg+2box,0.825,0.87,16410,3471,2442,18852.0,19881
ULSDL3D_000859_01_01_117_lesion_01.nii.gz,6,ct+seg+mask,0.645,0.949,17886,9842,966,18852.0,27728
ULSDL3D_000859_01_01_117_lesion_01.nii.gz,7,ct+seg+2mask,0.912,0.96,18092,1747,760,18852.0,19839
ULSDL3D_000863_02_01_056_lesion_01.nii.gz,1,ct,0.0,0.0,0,1,2196,2196.0,1
ULSDL3D_000863_02_01_056_lesion_01.nii.gz,2,ct+seg,0.136,0.985,2164,13710,32,2196.0,15874
ULSDL3D_000863_02_01_056_lesion_01.nii.gz,3,ct+seg+box,0.665,0.937,2057,1034,139,2196.0,3091
ULSDL3D_000863_02_01_056_lesion_01.nii.gz,5,ct+seg+2box,0.78,0.946,2078,585,118,2196.0,2663
ULSDL3D_000863_02_01_056_lesion_01.nii.gz,6,ct+seg+mask,0.665,0.994,2182,1100,14,2196.0,3282
ULSDL3D_000863_02_01_056_lesion_01.nii.gz,7,ct+seg+2mask,0.87,0.957,2102,314,94,2196.0,2416
ULSDL3D_000910_01_01_032_lesion_01.nii.gz,1,ct,0.958,0.263,251,11,704,955.0,262
ULSDL3D_000910_01_01_032_lesion_01.nii.gz,2,ct+seg,0.859,0.713,681,112,274,955.0,793
ULSDL3D_000910_01_01_032_lesion_01.nii.gz,3,ct+seg+box,0.959,0.272,260,11,695,955.0,271
ULSDL3D_000910_01_01_032_lesion_01.nii.gz,5,ct+seg+2box,0.926,0.641,612,49,343,955.0,661
ULSDL3D_000910_01_01_032_lesion_01.nii.gz,6,ct+seg+mask,0.963,0.359,343,13,612,955.0,356
ULSDL3D_000910_01_01_032_lesion_01.nii.gz,7,ct+seg+2mask,0.916,0.868,829,76,126,955.0,905
ULSDL3D_000910_05_02_547_lesion_01.nii.gz,1,ct,0.281,0.879,1062,2716,146,1208.0,3778
ULSDL3D_000910_05_02_547_lesion_01.nii.gz,2,ct+seg,0.336,0.581,702,1388,506,1208.0,2090
ULSDL3D_000910_05_02_547_lesion_01.nii.gz,3,ct+seg+box,0.475,0.964,1165,1290,43,1208.0,2455
ULSDL3D_000910_05_02_547_lesion_01.nii.gz,5,ct+seg+2box,0.814,0.876,1058,242,150,1208.0,1300
ULSDL3D_000910_05_02_547_lesion_01.nii.gz,6,ct+seg+mask,0.515,0.945,1142,1074,66,1208.0,2216
ULSDL3D_000910_05_02_547_lesion_01.nii.gz,7,ct+seg+2mask,0.953,0.695,839,41,369,1208.0,880
ULSDL3D_000985_02_01_115_lesion_01.nii.gz,1,ct,0.236,0.781,832,2689,233,1065.0,3521
ULSDL3D_000985_02_01_115_lesion_01.nii.gz,2,ct+seg,0.958,0.769,819,36,246,1065.0,855
ULSDL3D_000985_02_01_115_lesion_01.nii.gz,3,ct+seg+box,0.916,0.727,774,71,291,1065.0,845
ULSDL3D_000985_02_01_115_lesion_01.nii.gz,5,ct+seg+2box,0.876,0.773,823,116,242,1065.0,939
ULSDL3D_000985_02_01_115_lesion_01.nii.gz,6,ct+seg+mask,0.822,0.795,847,183,218,1065.0,1030
ULSDL3D_000985_02_01_115_lesion_01.nii.gz,7,ct+seg+2mask,0.954,0.695,740,36,325,1065.0,776
ULSDL3D_001021_02_01_028_lesion_01.nii.gz,1,ct,0.251,0.629,105,313,62,167.0,418
ULSDL3D_001021_02_01_028_lesion_01.nii.gz,2,ct+seg,0.304,0.557,93,213,74,167.0,306
ULSDL3D_001021_02_01_028_lesion_01.nii.gz,3,ct+seg+box,0.918,0.737,123,11,44,167.0,134
ULSDL3D_001021_02_01_028_lesion_01.nii.gz,5,ct+seg+2box,0.791,0.814,136,36,31,167.0,172
ULSDL3D_001021_02_01_028_lesion_01.nii.gz,6,ct+seg+mask,0.923,0.784,131,11,36,167.0,142
ULSDL3D_001021_02_01_028_lesion_01.nii.gz,7,ct+seg+2mask,0.928,0.85,142,11,25,167.0,153
ULSDL3D_001030_03_01_101_lesion_01.nii.gz,1,ct,0.198,0.686,312,1262,143,455.0,1574
ULSDL3D_001030_03_01_101_lesion_01.nii.gz,2,ct+seg,0.707,0.547,249,103,206,455.0,352
ULSDL3D_001030_03_01_101_lesion_01.nii.gz,3,ct+seg+box,0.0,0.0,0,0,455,455.0,0
ULSDL3D_001030_03_01_101_lesion_01.nii.gz,5,ct+seg+2box,0.964,0.532,242,9,213,455.0,251
ULSDL3D_001030_03_01_101_lesion_01.nii.gz,6,ct+seg+mask,0.0,0.0,0,1250,455,455.0,1250
ULSDL3D_001030_03_01_101_lesion_01.nii.gz,7,ct+seg+2mask,0.983,0.521,237,4,218,455.0,241
ULSDL3D_001050_05_02_519_lesion_01.nii.gz,1,ct,0.0,0.0,0,2446,237,237.0,2446
ULSDL3D_001050_05_02_519_lesion_01.nii.gz,2,ct+seg,0.019,0.122,29,1492,208,237.0,1521
ULSDL3D_001050_05_02_519_lesion_01.nii.gz,3,ct+seg+box,0.647,0.519,123,67,114,237.0,190
ULSDL3D_001050_05_02_519_lesion_01.nii.gz,5,ct+seg+2box,0.872,0.722,171,25,66,237.0,196
ULSDL3D_001050_05_02_519_lesion_01.nii.gz,6,ct+seg+mask,0.72,0.532,126,49,111,237.0,175
ULSDL3D_001050_05_02_519_lesion_01.nii.gz,7,ct+seg+2mask,0.97,0.692,164,5,73,237.0,169
ULSDL3D_001064_01_01_121_lesion_01.nii.gz,1,ct,0.961,0.717,1149,47,453,1602.0,1196
ULSDL3D_001064_01_01_121_lesion_01.nii.gz,2,ct+seg,0.954,0.743,1191,58,411,1602.0,1249
ULSDL3D_001064_01_01_121_lesion_01.nii.gz,3,ct+seg+box,0.958,0.641,1027,45,575,1602.0,1072
ULSDL3D_001064_01_01_121_lesion_01.nii.gz,5,ct+seg+2box,0.885,0.777,1245,162,357,1602.0,1407
ULSDL3D_001064_01_01_121_lesion_01.nii.gz,6,ct+seg+mask,0.969,0.502,804,26,798,1602.0,830
ULSDL3D_001064_01_01_121_lesion_01.nii.gz,7,ct+seg+2mask,0.952,0.738,1182,60,420,1602.0,1242
ULSDL3D_001079_03_03_140_lesion_01.nii.gz,1,ct,0.0,0.0,0,498,531,531.0,498
ULSDL3D_001079_03_03_140_lesion_01.nii.gz,2,ct+seg,0.0,0.0,0,0,531,531.0,0
ULSDL3D_001079_03_03_140_lesion_01.nii.gz,3,ct+seg+box,0.865,0.448,238,37,293,531.0,275
ULSDL3D_001079_03_03_140_lesion_01.nii.gz,5,ct+seg+2box,0.846,0.64,340,62,191,531.0,402
ULSDL3D_001079_03_03_140_lesion_01.nii.gz,6,ct+seg+mask,0.892,0.45,239,29,292,531.0,268
ULSDL3D_001079_03_03_140_lesion_01.nii.gz,7,ct+seg+2mask,0.895,0.676,359,42,172,531.0,401
ULSDL3D_001136_01_01_377_lesion_01.nii.gz,1,ct,0.052,0.854,123,2242,21,144.0,2365
ULSDL3D_001136_01_01_377_lesion_01.nii.gz,2,ct+seg,0.0,0.0,0,434,144,144.0,434
ULSDL3D_001136_01_01_377_lesion_01.nii.gz,3,ct+seg+box,0.0,0.0,0,0,144,144.0,0
ULSDL3D_001136_01_01_377_lesion_01.nii.gz,5,ct+seg+2box,0.776,0.674,97,28,47,144.0,125
ULSDL3D_001136_01_01_377_lesion_01.nii.gz,6,ct+seg+mask,0.0,0.0,0,1259,144,144.0,1259
ULSDL3D_001136_01_01_377_lesion_01.nii.gz,7,ct+seg+2mask,0.9,0.562,81,9,63,144.0,90
ULSDL3D_001152_02_01_066_lesion_01.nii.gz,1,ct,0.062,0.382,52,793,84,136.0,845
ULSDL3D_001152_02_01_066_lesion_01.nii.gz,2,ct+seg,0.026,0.647,88,3328,48,136.0,3416
ULSDL3D_001152_02_01_066_lesion_01.nii.gz,3,ct+seg+box,0.676,0.522,71,34,65,136.0,105
ULSDL3D_001152_02_01_066_lesion_01.nii.gz,5,ct+seg+2box,0.754,0.787,107,35,29,136.0,142
ULSDL3D_001152_02_01_066_lesion_01.nii.gz,6,ct+seg+mask,0.395,0.801,109,167,27,136.0,276
ULSDL3D_001152_02_01_066_lesion_01.nii.gz,7,ct+seg+2mask,0.852,0.846,115,20,21,136.0,135
ULSDL3D_001154_01_01_075_lesion_01.nii.gz,1,ct,0.0,0.0,0,1075,86,86.0,1075
ULSDL3D_001154_01_01_075_lesion_01.nii.gz,2,ct+seg,0.102,0.419,36,316,50,86.0,352
ULSDL3D_001154_01_01_075_lesion_01.nii.gz,3,ct+seg+box,0.246,0.698,60,184,26,86.0,244
ULSDL3D_001154_01_01_075_lesion_01.nii.gz,5,ct+seg+2box,0.5,0.663,57,57,29,86.0,114
ULSDL3D_001154_01_01_075_lesion_01.nii.gz,6,ct+seg+mask,0.189,0.884,76,326,10,86.0,402
ULSDL3D_001154_01_01_075_lesion_01.nii.gz,7,ct+seg+2mask,0.5,0.674,58,58,28,86.0,116
ULSDL3D_001166_01_01_033_lesion_01.nii.gz,1,ct,0.159,0.235,46,243,150,196.0,289
ULSDL3D_001166_01_01_033_lesion_01.nii.gz,2,ct+seg,0.125,0.265,52,363,144,196.0,415
ULSDL3D_001166_01_01_033_lesion_01.nii.gz,3,ct+seg+box,0.927,0.648,127,10,69,196.0,137
ULSDL3D_001166_01_01_033_lesion_01.nii.gz,5,ct+seg+2box,0.848,0.827,162,29,34,196.0,191
ULSDL3D_001166_01_01_033_lesion_01.nii.gz,6,ct+seg+mask,0.991,0.582,114,1,82,196.0,115
ULSDL3D_001166_01_01_033_lesion_01.nii.gz,7,ct+seg+2mask,0.987,0.786,154,2,42,196.0,156
ULSDL3D_001167_01_01_225_lesion_01.nii.gz,1,ct,0.196,0.721,269,1104,104,373.0,1373
ULSDL3D_001167_01_01_225_lesion_01.nii.gz,2,ct+seg,0.857,0.37,138,23,235,373.0,161
ULSDL3D_001167_01_01_225_lesion_01.nii.gz,3,ct+seg+box,0.0,0.0,0,0,373,373.0,0
ULSDL3D_001167_01_01_225_lesion_01.nii.gz,5,ct+seg+2box,0.962,0.469,175,7,198,373.0,182
ULSDL3D_001167_01_01_225_lesion_01.nii.gz,6,ct+seg+mask,0.0,0.0,0,27,373,373.0,27
ULSDL3D_001167_01_01_225_lesion_01.nii.gz,7,ct+seg+2mask,0.949,0.496,185,10,188,373.0,195
ULSDL3D_001185_02_01_114_lesion_01.nii.gz,1,ct,0.591,0.859,463,320,76,539.0,783
ULSDL3D_001185_02_01_114_lesion_01.nii.gz,2,ct+seg,0.056,0.954,514,8587,25,539.0,9101
ULSDL3D_001185_02_01_114_lesion_01.nii.gz,3,ct+seg+box,0.947,0.861,464,26,75,539.0,490
ULSDL3D_001185_02_01_114_lesion_01.nii.gz,5,ct+seg+2box,0.858,0.896,483,80,56,539.0,563
ULSDL3D_001185_02_01_114_lesion_01.nii.gz,6,ct+seg+mask,0.937,0.772,416,28,123,539.0,444
ULSDL3D_001185_02_01_114_lesion_01.nii.gz,7,ct+seg+2mask,0.976,0.924,498,12,41,539.0,510
ULSDL3D_001202_01_01_016_lesion_01.nii.gz,1,ct,0.0,0.0,0,153,126,126.0,153
ULSDL3D_001202_01_01_016_lesion_01.nii.gz,2,ct+seg,0.33,0.492,62,126,64,126.0,188
ULSDL3D_001202_01_01_016_lesion_01.nii.gz,3,ct+seg+box,0.679,0.738,93,44,33,126.0,137
ULSDL3D_001202_01_01_016_lesion_01.nii.gz,5,ct+seg+2box,0.674,0.937,118,57,8,126.0,175
ULSDL3D_001202_01_01_016_lesion_01.nii.gz,6,ct+seg+mask,0.71,0.698,88,36,38,126.0,124
ULSDL3D_001202_01_01_016_lesion_01.nii.gz,7,ct+seg+2mask,0.863,0.897,113,18,13,126.0,131
ULSDL3D_001213_01_01_023_lesion_01.nii.gz,1,ct,0.555,0.682,217,174,101,318.0,391
ULSDL3D_001213_01_01_023_lesion_01.nii.gz,2,ct+seg,0.939,0.629,200,13,118,318.0,213
ULSDL3D_001213_01_01_023_lesion_01.nii.gz,3,ct+seg+box,0.821,0.503,160,35,158,318.0,195
ULSDL3D_001213_01_01_023_lesion_01.nii.gz,5,ct+seg+2box,0.911,0.777,247,24,71,318.0,271
ULSDL3D_001213_01_01_023_lesion_01.nii.gz,6,ct+seg+mask,0.781,0.481,153,43,165,318.0,196
ULSDL3D_001213_01_01_023_lesion_01.nii.gz,7,ct+seg+2mask,0.959,0.811,258,11,60,318.0,269
ULSDL3D_001241_01_01_114_lesion_01.nii.gz,1,ct,0.73,0.797,585,216,149,734.0,801
ULSDL3D_001241_01_01_114_lesion_01.nii.gz,2,ct+seg,0.913,0.64,470,45,264,734.0,515
ULSDL3D_001241_01_01_114_lesion_01.nii.gz,3,ct+seg+box,0.848,0.616,452,81,282,734.0,533
ULSDL3D_001241_01_01_114_lesion_01.nii.gz,5,ct+seg+2box,0.763,0.684,502,156,232,734.0,658
ULSDL3D_001241_01_01_114_lesion_01.nii.gz,6,ct+seg+mask,0.699,0.691,507,218,227,734.0,725
ULSDL3D_001241_01_01_114_lesion_01.nii.gz,7,ct+seg+2mask,0.946,0.48,352,20,382,734.0,372
ULSDL3D_001249_01_01_080_lesion_01.nii.gz,1,ct,0.103,0.747,198,1725,67,265.0,1923
ULSDL3D_001249_01_01_080_lesion_01.nii.gz,2,ct+seg,0.03,0.668,177,5682,88,265.0,5859
ULSDL3D_001249_01_01_080_lesion_01.nii.gz,3,ct+seg+box,0.556,0.6,159,127,106,265.0,286
ULSDL3D_001249_01_01_080_lesion_01.nii.gz,5,ct+seg+2box,0.746,0.721,191,65,74,265.0,256
ULSDL3D_001249_01_01_080_lesion_01.nii.gz,6,ct+seg+mask,0.525,0.679,180,163,85,265.0,343
ULSDL3D_001249_01_01_080_lesion_01.nii.gz,7,ct+seg+2mask,0.908,0.785,208,21,57,265.0,229
ULSDL3D_001281_01_01_118_lesion_01.nii.gz,1,ct,0.01,0.004,5,485,1182,1187.0,490
ULSDL3D_001281_01_01_118_lesion_01.nii.gz,2,ct+seg,0.746,0.245,291,99,896,1187.0,390
ULSDL3D_001281_01_01_118_lesion_01.nii.gz,3,ct+seg+box,0.661,0.889,1055,542,132,1187.0,1597
ULSDL3D_001281_01_01_118_lesion_01.nii.gz,5,ct+seg+2box,0.831,0.859,1020,208,167,1187.0,1228
ULSDL3D_001281_01_01_118_lesion_01.nii.gz,6,ct+seg+mask,0.897,0.928,1101,126,86,1187.0,1227
ULSDL3D_001281_01_01_118_lesion_01.nii.gz,7,ct+seg+2mask,0.96,0.859,1020,42,167,1187.0,1062
ULSDL3D_001352_02_01_045_lesion_01.nii.gz,1,ct,0.0,0.0,0,214,257,257.0,214
ULSDL3D_001352_02_01_045_lesion_01.nii.gz,2,ct+seg,0.128,0.494,127,869,130,257.0,996
ULSDL3D_001352_02_01_045_lesion_01.nii.gz,3,ct+seg+box,0.865,0.599,154,24,103,257.0,178
ULSDL3D_001352_02_01_045_lesion_01.nii.gz,5,ct+seg+2box,0.795,0.724,186,48,71,257.0,234
ULSDL3D_001352_02_01_045_lesion_01.nii.gz,6,ct+seg+mask,0.898,0.685,176,20,81,257.0,196
ULSDL3D_001352_02_01_045_lesion_01.nii.gz,7,ct+seg+2mask,0.951,0.759,195,10,62,257.0,205
ULSDL3D_001430_02_01_034_lesion_01.nii.gz,1,ct,0.0,0.0,0,633,171,171.0,633
ULSDL3D_001430_02_01_034_lesion_01.nii.gz,2,ct+seg,0.16,0.906,155,814,16,171.0,969
ULSDL3D_001430_02_01_034_lesion_01.nii.gz,3,ct+seg+box,0.491,0.953,163,169,8,171.0,332
ULSDL3D_001430_02_01_034_lesion_01.nii.gz,5,ct+seg+2box,0.906,0.959,164,17,7,171.0,181
ULSDL3D_001430_02_01_034_lesion_01.nii.gz,6,ct+seg+mask,0.514,0.982,168,159,3,171.0,327
ULSDL3D_001430_02_01_034_lesion_01.nii.gz,7,ct+seg+2mask,1.0,0.901,154,0,17,171.0,154
ULSDL3D_001434_04_01_012_lesion_01.nii.gz,1,ct,0.326,0.733,252,520,92,344.0,772
ULSDL3D_001434_04_01_012_lesion_01.nii.gz,2,ct+seg,0.369,0.846,291,497,53,344.0,788
ULSDL3D_001434_04_01_012_lesion_01.nii.gz,3,ct+seg+box,0.715,0.826,284,113,60,344.0,397
ULSDL3D_001434_04_01_012_lesion_01.nii.gz,5,ct+seg+2box,0.874,0.884,304,44,40,344.0,348
ULSDL3D_001434_04_01_012_lesion_01.nii.gz,6,ct+seg+mask,0.712,0.767,264,107,80,344.0,371
ULSDL3D_001434_04_01_012_lesion_01.nii.gz,7,ct+seg+2mask,0.907,0.852,293,30,51,344.0,323
ULSDL3D_001521_02_01_043_lesion_01.nii.gz,1,ct,0.06,0.108,7,110,58,65.0,117
ULSDL3D_001521_02_01_043_lesion_01.nii.gz,2,ct+seg,0.878,0.662,43,6,22,65.0,49
ULSDL3D_001521_02_01_043_lesion_01.nii.gz,3,ct+seg+box,0.918,0.692,45,4,20,65.0,49
ULSDL3D_001521_02_01_043_lesion_01.nii.gz,5,ct+seg+2box,0.826,0.877,57,12,8,65.0,69
ULSDL3D_001521_02_01_043_lesion_01.nii.gz,6,ct+seg+mask,0.775,0.846,55,16,10,65.0,71
ULSDL3D_001521_02_01_043_lesion_01.nii.gz,7,ct+seg+2mask,0.932,0.846,55,4,10,65.0,59
ULSDL3D_001588_05_01_062_lesion_01.nii.gz,1,ct,0.0,0.0,0,143,781,781.0,143
ULSDL3D_001588_05_01_062_lesion_01.nii.gz,2,ct+seg,0.614,0.872,681,428,100,781.0,1109
ULSDL3D_001588_05_01_062_lesion_01.nii.gz,3,ct+seg+box,0.798,0.84,656,166,125,781.0,822
ULSDL3D_001588_05_01_062_lesion_01.nii.gz,5,ct+seg+2box,0.857,0.859,671,112,110,781.0,783
ULSDL3D_001588_05_01_062_lesion_01.nii.gz,6,ct+seg+mask,0.865,0.823,643,100,138,781.0,743
ULSDL3D_001588_05_01_062_lesion_01.nii.gz,7,ct+seg+2mask,0.919,0.917,716,63,65,781.0,779
ULSDL3D_001591_03_02_132_lesion_01.nii.gz,1,ct,0.933,0.451,461,33,561,1022.0,494
ULSDL3D_001591_03_02_132_lesion_01.nii.gz,2,ct+seg,0.268,0.059,60,164,962,1022.0,224
ULSDL3D_001591_03_02_132_lesion_01.nii.gz,3,ct+seg+box,0.835,0.406,415,82,607,1022.0,497
ULSDL3D_001591_03_02_132_lesion_01.nii.gz,5,ct+seg+2box,0.641,0.894,914,511,108,1022.0,1425
ULSDL3D_001591_03_02_132_lesion_01.nii.gz,6,ct+seg+mask,0.94,0.426,435,28,587,1022.0,463
ULSDL3D_001591_03_02_132_lesion_01.nii.gz,7,ct+seg+2mask,0.903,0.714,730,78,292,1022.0,808
ULSDL3D_001591_03_02_359_lesion_01.nii.gz,1,ct,0.16,0.73,325,1710,120,445.0,2035
ULSDL3D_001591_03_02_359_lesion_01.nii.gz,2,ct+seg,0.0,0.0,0,1779,445,445.0,1779
ULSDL3D_001591_03_02_359_lesion_01.nii.gz,3,ct+seg+box,0.792,0.901,401,105,44,445.0,506
ULSDL3D_001591_03_02_359_lesion_01.nii.gz,5,ct+seg+2box,0.958,0.764,340,15,105,445.0,355
ULSDL3D_001591_03_02_359_lesion_01.nii.gz,6,ct+seg+mask,0.857,0.838,373,62,72,445.0,435
ULSDL3D_001591_03_02_359_lesion_01.nii.gz,7,ct+seg+2mask,0.992,0.593,264,2,181,445.0,266
ULSDL3D_001596_03_02_197_lesion_01.nii.gz,1,ct,0.529,0.749,499,444,167,666.0,943
ULSDL3D_001596_03_02_197_lesion_01.nii.gz,2,ct+seg,0.677,0.447,298,142,368,666.0,440
ULSDL3D_001596_03_02_197_lesion_01.nii.gz,3,ct+seg+box,0.759,0.656,437,139,229,666.0,576
ULSDL3D_001596_03_02_197_lesion_01.nii.gz,5,ct+seg+2box,0.79,0.745,496,132,170,666.0,628
ULSDL3D_001596_03_02_197_lesion_01.nii.gz,6,ct+seg+mask,0.729,0.752,501,186,165,666.0,687
ULSDL3D_001596_03_02_197_lesion_01.nii.gz,7,ct+seg+2mask,0.9,0.733,488,54,178,666.0,542
ULSDL3D_001596_03_02_448_lesion_01.nii.gz,1,ct,0.098,0.426,360,3325,485,845.0,3685
ULSDL3D_001596_03_02_448_lesion_01.nii.gz,2,ct+seg,0.653,0.349,295,157,550,845.0,452
ULSDL3D_001596_03_02_448_lesion_01.nii.gz,3,ct+seg+box,0.263,0.981,829,2325,16,845.0,3154
ULSDL3D_001596_03_02_448_lesion_01.nii.gz,5,ct+seg+2box,0.914,0.702,593,56,252,845.0,649
ULSDL3D_001596_03_02_448_lesion_01.nii.gz,6,ct+seg+mask,0.333,0.964,815,1630,30,845.0,2445
ULSDL3D_001596_03_02_448_lesion_01.nii.gz,7,ct+seg+2mask,0.955,0.677,572,27,273,845.0,599
ULSDL3D_001736_07_02_062_lesion_01.nii.gz,1,ct,0.0,0.0,0,90,2986,2986.0,90
ULSDL3D_001736_07_02_062_lesion_01.nii.gz,2,ct+seg,0.004,0.024,72,16499,2914,2986.0,16571
ULSDL3D_001736_07_02_062_lesion_01.nii.gz,3,ct+seg+box,0.483,0.877,2618,2806,368,2986.0,5424
ULSDL3D_001736_07_02_062_lesion_01.nii.gz,5,ct+seg+2box,0.834,0.883,2638,525,348,2986.0,3163
ULSDL3D_001736_07_02_062_lesion_01.nii.gz,6,ct+seg+mask,0.468,0.941,2810,3192,176,2986.0,6002
ULSDL3D_001736_07_02_062_lesion_01.nii.gz,7,ct+seg+2mask,0.88,0.967,2887,393,99,2986.0,3280
ULSDL3D_001775_03_01_024_lesion_01.nii.gz,1,ct,0.914,0.513,255,24,242,497.0,279
ULSDL3D_001775_03_01_024_lesion_01.nii.gz,2,ct+seg,0.983,0.688,342,6,155,497.0,348
ULSDL3D_001775_03_01_024_lesion_01.nii.gz,3,ct+seg+box,0.945,0.344,171,10,326,497.0,181
ULSDL3D_001775_03_01_024_lesion_01.nii.gz,5,ct+seg+2box,0.741,0.765,380,133,117,497.0,513
ULSDL3D_001775_03_01_024_lesion_01.nii.gz,6,ct+seg+mask,0.952,0.32,159,8,338,497.0,167
ULSDL3D_001775_03_01_024_lesion_01.nii.gz,7,ct+seg+2mask,0.96,0.869,432,18,65,497.0,450
ULSDL3D_001867_01_01_047_lesion_01.nii.gz,1,ct,0.171,0.523,280,1361,255,535.0,1641
ULSDL3D_001867_01_01_047_lesion_01.nii.gz,2,ct+seg,0.707,0.243,130,54,405,535.0,184
ULSDL3D_001867_01_01_047_lesion_01.nii.gz,3,ct+seg+box,0.63,0.778,416,244,119,535.0,660
ULSDL3D_001867_01_01_047_lesion_01.nii.gz,5,ct+seg+2box,0.807,0.787,421,101,114,535.0,522
ULSDL3D_001867_01_01_047_lesion_01.nii.gz,6,ct+seg+mask,0.849,0.643,344,61,191,535.0,405
ULSDL3D_001867_01_01_047_lesion_01.nii.gz,7,ct+seg+2mask,0.922,0.688,368,31,167,535.0,399
ULSDL3D_001874_01_01_381_lesion_01.nii.gz,1,ct,0.044,0.176,45,981,210,255.0,1026
ULSDL3D_001874_01_01_381_lesion_01.nii.gz,2,ct+seg,0.0,0.0,0,700,255,255.0,700
ULSDL3D_001874_01_01_381_lesion_01.nii.gz,3,ct+seg+box,0.518,0.914,233,217,22,255.0,450
ULSDL3D_001874_01_01_381_lesion_01.nii.gz,5,ct+seg+2box,0.646,0.867,221,121,34,255.0,342
ULSDL3D_001874_01_01_381_lesion_01.nii.gz,6,ct+seg+mask,0.594,0.914,233,159,22,255.0,392
ULSDL3D_001874_01_01_381_lesion_01.nii.gz,7,ct+seg+2mask,0.87,0.71,181,27,74,255.0,208
ULSDL3D_001933_02_01_098_lesion_01.nii.gz,1,ct,0.0,0.0,0,1372,210,210.0,1372
ULSDL3D_001933_02_01_098_lesion_01.nii.gz,2,ct+seg,0.012,0.371,78,6610,132,210.0,6688
ULSDL3D_001933_02_01_098_lesion_01.nii.gz,3,ct+seg+box,0.688,0.419,88,40,122,210.0,128
ULSDL3D_001933_02_01_098_lesion_01.nii.gz,5,ct+seg+2box,0.595,0.671,141,96,69,210.0,237
ULSDL3D_001933_02_01_098_lesion_01.nii.gz,6,ct+seg+mask,0.804,0.41,86,21,124,210.0,107
ULSDL3D_001933_02_01_098_lesion_01.nii.gz,7,ct+seg+2mask,0.859,0.757,159,26,51,210.0,185
ULSDL3D_001970_06_01_069_lesion_01.nii.gz,1,ct,0.136,1.0,122,772,0,122.0,894
ULSDL3D_001970_06_01_069_lesion_01.nii.gz,2,ct+seg,0.7,0.689,84,36,38,122.0,120
ULSDL3D_001970_06_01_069_lesion_01.nii.gz,3,ct+seg+box,0.0,0.0,0,0,122,122.0,0
ULSDL3D_001970_06_01_069_lesion_01.nii.gz,5,ct+seg+2box,0.848,0.73,89,16,33,122.0,105
ULSDL3D_001970_06_01_069_lesion_01.nii.gz,6,ct+seg+mask,0.0,0.0,0,0,122,122.0,0
ULSDL3D_001970_06_01_069_lesion_01.nii.gz,7,ct+seg+2mask,0.856,0.631,77,13,45,122.0,90
ULSDL3D_001970_07_01_070_lesion_01.nii.gz,1,ct,0.103,1.0,135,1179,0,135.0,1314
ULSDL3D_001970_07_01_070_lesion_01.nii.gz,2,ct+seg,0.754,0.681,92,30,43,135.0,122
ULSDL3D_001970_07_01_070_lesion_01.nii.gz,3,ct+seg+box,0.0,0.0,0,0,135,135.0,0
ULSDL3D_001970_07_01_070_lesion_01.nii.gz,5,ct+seg+2box,0.934,0.526,71,5,64,135.0,76
ULSDL3D_001970_07_01_070_lesion_01.nii.gz,6,ct+seg+mask,0.0,0.0,0,92,135,135.0,92
ULSDL3D_001970_07_01_070_lesion_01.nii.gz,7,ct+seg+2mask,0.933,0.519,70,5,65,135.0,75
ULSDL3D_002035_02_01_039_lesion_01.nii.gz,1,ct,0.406,0.592,170,249,117,287.0,419
ULSDL3D_002035_02_01_039_lesion_01.nii.gz,2,ct+seg,0.099,0.659,189,1720,98,287.0,1909
ULSDL3D_002035_02_01_039_lesion_01.nii.gz,3,ct+seg+box,0.708,0.784,225,93,62,287.0,318
ULSDL3D_002035_02_01_039_lesion_01.nii.gz,5,ct+seg+2box,0.691,0.833,239,107,48,287.0,346
ULSDL3D_002035_02_01_039_lesion_01.nii.gz,6,ct+seg+mask,0.636,0.878,252,144,35,287.0,396
ULSDL3D_002035_02_01_039_lesion_01.nii.gz,7,ct+seg+2mask,0.715,0.777,223,89,64,287.0,312
ULSDL3D_002046_01_01_070_lesion_01.nii.gz,1,ct,0.764,0.936,336,104,23,359.0,440
ULSDL3D_002046_01_01_070_lesion_01.nii.gz,2,ct+seg,0.94,0.919,330,21,29,359.0,351
ULSDL3D_002046_01_01_070_lesion_01.nii.gz,3,ct+seg+box,0.952,0.602,216,11,143,359.0,227
ULSDL3D_002046_01_01_070_lesion_01.nii.gz,5,ct+seg+2box,0.938,0.836,300,20,59,359.0,320
ULSDL3D_002046_01_01_070_lesion_01.nii.gz,6,ct+seg+mask,0.995,0.51,183,1,176,359.0,184
ULSDL3D_002046_01_01_070_lesion_01.nii.gz,7,ct+seg+2mask,0.974,0.838,301,8,58,359.0,309
ULSDL3D_002116_01_01_116_lesion_01.nii.gz,1,ct,0.957,0.918,661,30,59,720.0,691
ULSDL3D_002116_01_01_116_lesion_01.nii.gz,2,ct+seg,0.956,0.938,675,31,45,720.0,706
ULSDL3D_002116_01_01_116_lesion_01.nii.gz,3,ct+seg+box,0.945,0.914,658,38,62,720.0,696
ULSDL3D_002116_01_01_116_lesion_01.nii.gz,5,ct+seg+2box,0.961,0.864,622,25,98,720.0,647
ULSDL3D_002116_01_01_116_lesion_01.nii.gz,6,ct+seg+mask,0.917,0.91,655,59,65,720.0,714
ULSDL3D_002116_01_01_116_lesion_01.nii.gz,7,ct+seg+2mask,0.972,0.915,659,19,61,720.0,678
ULSDL3D_002135_01_02_213_lesion_01.nii.gz,1,ct,0.79,0.537,1163,310,1003,2166.0,1473
ULSDL3D_002135_01_02_213_lesion_01.nii.gz,2,ct+seg,0.02,0.001,3,150,2163,2166.0,153
ULSDL3D_002135_01_02_213_lesion_01.nii.gz,3,ct+seg+box,0.0,0.0,0,0,2166,2166.0,0
ULSDL3D_002135_01_02_213_lesion_01.nii.gz,5,ct+seg+2box,0.619,0.773,1675,1032,491,2166.0,2707
ULSDL3D_002135_01_02_213_lesion_01.nii.gz,6,ct+seg+mask,0.0,0.0,0,438,2166,2166.0,438
ULSDL3D_002135_01_02_213_lesion_01.nii.gz,7,ct+seg+2mask,0.621,0.854,1850,1128,316,2166.0,2978
ULSDL3D_002176_01_01_058_lesion_01.nii.gz,1,ct,0.0,0.0,0,841,108,108.0,841
ULSDL3D_002176_01_01_058_lesion_01.nii.gz,2,ct+seg,0.511,0.833,90,86,18,108.0,176
ULSDL3D_002176_01_01_058_lesion_01.nii.gz,3,ct+seg+box,0.723,0.63,68,26,40,108.0,94
ULSDL3D_002176_01_01_058_lesion_01.nii.gz,5,ct+seg+2box,0.806,0.731,79,19,29,108.0,98
ULSDL3D_002176_01_01_058_lesion_01.nii.gz,6,ct+seg+mask,0.687,0.63,68,31,40,108.0,99
ULSDL3D_002176_01_01_058_lesion_01.nii.gz,7,ct+seg+2mask,0.955,0.593,64,3,44,108.0,67
ULSDL3D_002187_01_01_090_lesion_01.nii.gz,1,ct,0.053,0.767,310,5590,94,404.0,5900
ULSDL3D_002187_01_01_090_lesion_01.nii.gz,2,ct+seg,0.11,0.691,279,2252,125,404.0,2531
ULSDL3D_002187_01_01_090_lesion_01.nii.gz,3,ct+seg+box,0.964,0.661,267,10,137,404.0,277
ULSDL3D_002187_01_01_090_lesion_01.nii.gz,5,ct+seg+2box,0.906,0.743,300,31,104,404.0,331
ULSDL3D_002187_01_01_090_lesion_01.nii.gz,6,ct+seg+mask,0.948,0.723,292,16,112,404.0,308
ULSDL3D_002187_01_01_090_lesion_01.nii.gz,7,ct+seg+2mask,0.895,0.785,317,37,87,404.0,354
ULSDL3D_002358_02_03_017_lesion_01.nii.gz,1,ct,0.0,0.0,0,1725,568,568.0,1725
ULSDL3D_002358_02_03_017_lesion_01.nii.gz,2,ct+seg,0.0,0.0,0,30,568,568.0,30
ULSDL3D_002358_02_03_017_lesion_01.nii.gz,3,ct+seg+box,0.967,0.363,206,7,362,568.0,213
ULSDL3D_002358_02_03_017_lesion_01.nii.gz,5,ct+seg+2box,0.929,0.692,393,30,175,568.0,423
ULSDL3D_002358_02_03_017_lesion_01.nii.gz,6,ct+seg+mask,0.957,0.43,244,11,324,568.0,255
ULSDL3D_002358_02_03_017_lesion_01.nii.gz,7,ct+seg+2mask,0.949,0.625,355,19,213,568.0,374
ULSDL3D_002385_01_01_234_lesion_01.nii.gz,1,ct,0.079,0.967,175,2039,6,181.0,2214
ULSDL3D_002385_01_01_234_lesion_01.nii.gz,2,ct+seg,0.0,0.0,0,300,181,181.0,300
ULSDL3D_002385_01_01_234_lesion_01.nii.gz,3,ct+seg+box,0.986,0.392,71,1,110,181.0,72
ULSDL3D_002385_01_01_234_lesion_01.nii.gz,5,ct+seg+2box,0.98,0.53,96,2,85,181.0,98
ULSDL3D_002385_01_01_234_lesion_01.nii.gz,6,ct+seg+mask,0.889,0.486,88,11,93,181.0,99
ULSDL3D_002385_01_01_234_lesion_01.nii.gz,7,ct+seg+2mask,0.951,0.536,97,5,84,181.0,102
ULSDL3D_002386_01_01_131_lesion_01.nii.gz,1,ct,0.975,0.639,578,15,327,905.0,593
ULSDL3D_002386_01_01_131_lesion_01.nii.gz,2,ct+seg,0.602,0.909,823,543,82,905.0,1366
ULSDL3D_002386_01_01_131_lesion_01.nii.gz,3,ct+seg+box,0.97,0.863,781,24,124,905.0,805
ULSDL3D_002386_01_01_131_lesion_01.nii.gz,5,ct+seg+2box,0.879,0.952,862,119,43,905.0,981
ULSDL3D_002386_01_01_131_lesion_01.nii.gz,6,ct+seg+mask,0.908,0.891,806,82,99,905.0,888
ULSDL3D_002386_01_01_131_lesion_01.nii.gz,7,ct+seg+2mask,0.948,0.951,861,47,44,905.0,908
ULSDL3D_002406_01_02_354_lesion_01.nii.gz,1,ct,0.457,0.767,864,1025,263,1127.0,1889
ULSDL3D_002406_01_02_354_lesion_01.nii.gz,2,ct+seg,0.391,0.482,543,847,584,1127.0,1390
ULSDL3D_002406_01_02_354_lesion_01.nii.gz,3,ct+seg+box,0.926,0.589,664,53,463,1127.0,717
ULSDL3D_002406_01_02_354_lesion_01.nii.gz,5,ct+seg+2box,0.927,0.867,977,77,150,1127.0,1054
ULSDL3D_002406_01_02_354_lesion_01.nii.gz,6,ct+seg+mask,0.971,0.677,763,23,364,1127.0,786
ULSDL3D_002406_01_02_354_lesion_01.nii.gz,7,ct+seg+2mask,0.981,0.831,937,18,190,1127.0,955
ULSDL3D_002406_02_01_345_lesion_01.nii.gz,1,ct,0.0,0.0,0,2477,1380,1380.0,2477
ULSDL3D_002406_02_01_345_lesion_01.nii.gz,2,ct+seg,1.0,0.054,75,0,1305,1380.0,75
ULSDL3D_002406_02_01_345_lesion_01.nii.gz,3,ct+seg+box,0.926,0.609,841,67,539,1380.0,908
ULSDL3D_002406_02_01_345_lesion_01.nii.gz,5,ct+seg+2box,0.867,0.798,1101,169,279,1380.0,1270
ULSDL3D_002406_02_01_345_lesion_01.nii.gz,6,ct+seg+mask,0.962,0.651,898,35,482,1380.0,933
ULSDL3D_002406_02_01_345_lesion_01.nii.gz,7,ct+seg+2mask,0.968,0.751,1036,34,344,1380.0,1070
ULSDL3D_002418_03_01_034_lesion_01.nii.gz,1,ct,0.0,0.0,0,53,244,244.0,53
ULSDL3D_002418_03_01_034_lesion_01.nii.gz,2,ct+seg,0.971,0.553,135,4,109,244.0,139
ULSDL3D_002418_03_01_034_lesion_01.nii.gz,3,ct+seg+box,0.908,0.73,178,18,66,244.0,196
ULSDL3D_002418_03_01_034_lesion_01.nii.gz,5,ct+seg+2box,0.741,0.889,217,76,27,244.0,293
ULSDL3D_002418_03_01_034_lesion_01.nii.gz,6,ct+seg+mask,0.881,0.701,171,23,73,244.0,194
ULSDL3D_002418_03_01_034_lesion_01.nii.gz,7,ct+seg+2mask,0.957,0.82,200,9,44,244.0,209
ULSDL3D_002432_02_01_226_lesion_01.nii.gz,1,ct,0.349,0.763,206,385,64,270.0,591
ULSDL3D_002432_02_01_226_lesion_01.nii.gz,2,ct+seg,0.416,0.374,101,142,169,270.0,243
ULSDL3D_002432_02_01_226_lesion_01.nii.gz,3,ct+seg+box,0.952,0.667,180,9,90,270.0,189
ULSDL3D_002432_02_01_226_lesion_01.nii.gz,5,ct+seg+2box,0.947,0.659,178,10,92,270.0,188
ULSDL3D_002432_02_01_226_lesion_01.nii.gz,6,ct+seg+mask,0.878,0.856,231,32,39,270.0,263
ULSDL3D_002432_02_01_226_lesion_01.nii.gz,7,ct+seg+2mask,1.0,0.63,170,0,100,270.0,170
ULSDL3D_002455_01_01_149_lesion_01.nii.gz,1,ct,0.211,0.977,259,967,6,265.0,1226
ULSDL3D_002455_01_01_149_lesion_01.nii.gz,2,ct+seg,0.676,0.694,184,88,81,265.0,272
ULSDL3D_002455_01_01_149_lesion_01.nii.gz,3,ct+seg+box,0.871,0.762,202,30,63,265.0,232
ULSDL3D_002455_01_01_149_lesion_01.nii.gz,5,ct+seg+2box,0.938,0.626,166,11,99,265.0,177
ULSDL3D_002455_01_01_149_lesion_01.nii.gz,6,ct+seg+mask,0.707,0.8,212,88,53,265.0,300
ULSDL3D_002455_01_01_149_lesion_01.nii.gz,7,ct+seg+2mask,0.954,0.623,165,8,100,265.0,173
ULSDL3D_002464_01_01_243_lesion_01.nii.gz,1,ct,0.261,0.209,382,1082,1444,1826.0,1464
ULSDL3D_002464_01_01_243_lesion_01.nii.gz,2,ct+seg,0.782,0.283,516,144,1310,1826.0,660
ULSDL3D_002464_01_01_243_lesion_01.nii.gz,3,ct+seg+box,0.451,0.608,1110,1349,716,1826.0,2459
ULSDL3D_002464_01_01_243_lesion_01.nii.gz,5,ct+seg+2box,0.424,0.811,1481,2013,345,1826.0,3494
ULSDL3D_002464_01_01_243_lesion_01.nii.gz,6,ct+seg+mask,0.584,0.521,951,677,875,1826.0,1628
ULSDL3D_002464_01_01_243_lesion_01.nii.gz,7,ct+seg+2mask,0.747,0.693,1265,428,561,1826.0,1693
ULSDL3D_002561_05_01_032_lesion_01.nii.gz,1,ct,0.047,0.379,86,1735,141,227.0,1821
ULSDL3D_002561_05_01_032_lesion_01.nii.gz,2,ct+seg,0.0,0.0,0,255,227,227.0,255
ULSDL3D_002561_05_01_032_lesion_01.nii.gz,3,ct+seg+box,0.0,0.0,0,0,227,227.0,0
ULSDL3D_002561_05_01_032_lesion_01.nii.gz,5,ct+seg+2box,0.88,0.775,176,24,51,227.0,200
ULSDL3D_002561_05_01_032_lesion_01.nii.gz,6,ct+seg+mask,0.0,0.0,0,896,227,227.0,896
ULSDL3D_002561_05_01_032_lesion_01.nii.gz,7,ct+seg+2mask,0.916,0.718,163,15,64,227.0,178
ULSDL3D_002642_01_02_022_lesion_01.nii.gz,1,ct,0.476,0.537,79,87,68,147.0,166
ULSDL3D_002642_01_02_022_lesion_01.nii.gz,2,ct+seg,0.978,0.605,89,2,58,147.0,91
ULSDL3D_002642_01_02_022_lesion_01.nii.gz,3,ct+seg+box,0.884,0.776,114,15,33,147.0,129
ULSDL3D_002642_01_02_022_lesion_01.nii.gz,5,ct+seg+2box,0.796,0.905,133,34,14,147.0,167
ULSDL3D_002642_01_02_022_lesion_01.nii.gz,6,ct+seg+mask,0.889,0.816,120,15,27,147.0,135
ULSDL3D_002642_01_02_022_lesion_01.nii.gz,7,ct+seg+2mask,0.955,0.857,126,6,21,147.0,132
ULSDL3D_002656_01_01_023_lesion_01.nii.gz,1,ct,0.0,0.0,0,213,59,59.0,213
ULSDL3D_002656_01_01_023_lesion_01.nii.gz,2,ct+seg,0.097,0.966,57,530,2,59.0,587
ULSDL3D_002656_01_01_023_lesion_01.nii.gz,3,ct+seg+box,0.629,0.949,56,33,3,59.0,89
ULSDL3D_002656_01_01_023_lesion_01.nii.gz,5,ct+seg+2box,0.963,0.881,52,2,7,59.0,54
ULSDL3D_002656_01_01_023_lesion_01.nii.gz,6,ct+seg+mask,0.644,0.983,58,32,1,59.0,90
ULSDL3D_002656_01_01_023_lesion_01.nii.gz,7,ct+seg+2mask,1.0,0.898,53,0,6,59.0,53
ULSDL3D_002774_01_01_029_lesion_01.nii.gz,1,ct,0.0,0.0,0,51,297,297.0,51
ULSDL3D_002774_01_01_029_lesion_01.nii.gz,2,ct+seg,0.572,0.532,158,118,139,297.0,276
ULSDL3D_002774_01_01_029_lesion_01.nii.gz,3,ct+seg+box,0.522,0.879,261,239,36,297.0,500
ULSDL3D_002774_01_01_029_lesion_01.nii.gz,5,ct+seg+2box,0.783,0.936,278,77,19,297.0,355
ULSDL3D_002774_01_01_029_lesion_01.nii.gz,6,ct+seg+mask,0.612,0.997,296,188,1,297.0,484
ULSDL3D_002774_01_01_029_lesion_01.nii.gz,7,ct+seg+2mask,0.982,0.909,270,5,27,297.0,275
ULSDL3D_002783_04_01_330_lesion_01.nii.gz,1,ct,0.0,0.0,0,2371,275,275.0,2371
ULSDL3D_002783_04_01_330_lesion_01.nii.gz,2,ct+seg,0.022,0.029,8,357,267,275.0,365
ULSDL3D_002783_04_01_330_lesion_01.nii.gz,3,ct+seg+box,0.0,0.0,0,0,275,275.0,0
ULSDL3D_002783_04_01_330_lesion_01.nii.gz,5,ct+seg+2box,0.501,0.887,244,243,31,275.0,487
ULSDL3D_002783_04_01_330_lesion_01.nii.gz,6,ct+seg+mask,0.0,0.0,0,1359,275,275.0,1359
ULSDL3D_002783_04_01_330_lesion_01.nii.gz,7,ct+seg+2mask,0.457,0.964,265,315,10,275.0,580
ULSDL3D_002796_03_02_404_lesion_01.nii.gz,1,ct,0.491,0.497,801,831,810,1611.0,1632
ULSDL3D_002796_03_02_404_lesion_01.nii.gz,2,ct+seg,0.962,0.765,1233,49,378,1611.0,1282
ULSDL3D_002796_03_02_404_lesion_01.nii.gz,3,ct+seg+box,0.0,0.0,0,0,1611,1611.0,0
ULSDL3D_002796_03_02_404_lesion_01.nii.gz,5,ct+seg+2box,0.8,0.884,1424,357,187,1611.0,1781
ULSDL3D_002796_03_02_404_lesion_01.nii.gz,6,ct+seg+mask,0.0,0.0,0,762,1611,1611.0,762
ULSDL3D_002796_03_02_404_lesion_01.nii.gz,7,ct+seg+2mask,0.884,0.868,1398,183,213,1611.0,1581
ULSDL3D_002812_08_01_090_lesion_01.nii.gz,1,ct,0.0,0.0,0,96,115,115.0,96
ULSDL3D_002812_08_01_090_lesion_01.nii.gz,2,ct+seg,0.266,0.635,73,201,42,115.0,274
ULSDL3D_002812_08_01_090_lesion_01.nii.gz,3,ct+seg+box,0.846,0.861,99,18,16,115.0,117
ULSDL3D_002812_08_01_090_lesion_01.nii.gz,5,ct+seg+2box,0.85,0.983,113,20,2,115.0,133
ULSDL3D_002812_08_01_090_lesion_01.nii.gz,6,ct+seg+mask,0.785,0.887,102,28,13,115.0,130
ULSDL3D_002812_08_01_090_lesion_01.nii.gz,7,ct+seg+2mask,0.972,0.896,103,3,12,115.0,106
ULSDL3D_002885_07_02_456_lesion_01.nii.gz,1,ct,0.795,0.909,1494,385,149,1643.0,1879
ULSDL3D_002885_07_02_456_lesion_01.nii.gz,2,ct+seg,0.937,0.898,1476,99,167,1643.0,1575
ULSDL3D_002885_07_02_456_lesion_01.nii.gz,3,ct+seg+box,0.969,0.526,865,28,778,1643.0,893
ULSDL3D_002885_07_02_456_lesion_01.nii.gz,5,ct+seg+2box,0.9,0.858,1409,156,234,1643.0,1565
ULSDL3D_002885_07_02_456_lesion_01.nii.gz,6,ct+seg+mask,0.974,0.594,976,26,667,1643.0,1002
ULSDL3D_002885_07_02_456_lesion_01.nii.gz,7,ct+seg+2mask,0.962,0.884,1453,57,190,1643.0,1510
ULSDL3D_002900_01_01_073_lesion_01.nii.gz,1,ct,0.0,0.0,0,711,81,81.0,711
ULSDL3D_002900_01_01_073_lesion_01.nii.gz,2,ct+seg,0.144,0.691,56,333,25,81.0,389
ULSDL3D_002900_01_01_073_lesion_01.nii.gz,3,ct+seg+box,0.425,0.975,79,107,2,81.0,186
ULSDL3D_002900_01_01_073_lesion_01.nii.gz,5,ct+seg+2box,0.594,0.975,79,54,2,81.0,133
ULSDL3D_002900_01_01_073_lesion_01.nii.gz,6,ct+seg+mask,0.576,0.988,80,59,1,81.0,139
ULSDL3D_002900_01_01_073_lesion_01.nii.gz,7,ct+seg+2mask,0.962,0.951,77,3,4,81.0,80
ULSDL3D_002935_04_02_013_lesion_01.nii.gz,1,ct,0.14,0.759,88,542,28,116.0,630
ULSDL3D_002935_04_02_013_lesion_01.nii.gz,2,ct+seg,0.245,0.793,92,283,24,116.0,375
ULSDL3D_002935_04_02_013_lesion_01.nii.gz,3,ct+seg+box,0.841,0.819,95,18,21,116.0,113
ULSDL3D_002935_04_02_013_lesion_01.nii.gz,5,ct+seg+2box,0.937,0.897,104,7,12,116.0,111
ULSDL3D_002935_04_02_013_lesion_01.nii.gz,6,ct+seg+mask,0.804,0.776,90,22,26,116.0,112
ULSDL3D_002935_04_02_013_lesion_01.nii.gz,7,ct+seg+2mask,0.982,0.922,107,2,9,116.0,109
ULSDL3D_002948_02_02_138_lesion_01.nii.gz,1,ct,0.973,0.653,2658,74,1410,4068.0,2732
ULSDL3D_002948_02_02_138_lesion_01.nii.gz,2,ct+seg,0.981,0.711,2892,56,1176,4068.0,2948
ULSDL3D_002948_02_02_138_lesion_01.nii.gz,3,ct+seg+box,0.0,0.0,0,0,4068,4068.0,0
ULSDL3D_002948_02_02_138_lesion_01.nii.gz,5,ct+seg+2box,0.805,0.827,3365,814,703,4068.0,4179
ULSDL3D_002948_02_02_138_lesion_01.nii.gz,6,ct+seg+mask,0.84,0.37,1505,287,2563,4068.0,1792
ULSDL3D_002948_02_02_138_lesion_01.nii.gz,7,ct+seg+2mask,0.874,0.733,2983,430,1085,4068.0,3413
ULSDL3D_002965_02_01_037_lesion_01.nii.gz,1,ct,0.355,0.93,280,508,21,301.0,788
ULSDL3D_002965_02_01_037_lesion_01.nii.gz,2,ct+seg,0.214,0.89,268,987,33,301.0,1255
ULSDL3D_002965_02_01_037_lesion_01.nii.gz,3,ct+seg+box,0.893,0.917,276,33,25,301.0,309
ULSDL3D_002965_02_01_037_lesion_01.nii.gz,5,ct+seg+2box,0.882,0.897,270,36,31,301.0,306
ULSDL3D_002965_02_01_037_lesion_01.nii.gz,6,ct+seg+mask,0.911,0.914,275,27,26,301.0,302
ULSDL3D_002965_02_01_037_lesion_01.nii.gz,7,ct+seg+2mask,0.958,0.917,276,12,25,301.0,288
ULSDL3D_002965_02_01_060_lesion_01.nii.gz,1,ct,0.0,0.0,0,1105,211,211.0,1105
ULSDL3D_002965_02_01_060_lesion_01.nii.gz,2,ct+seg,0.013,0.716,151,11511,60,211.0,11662
ULSDL3D_002965_02_01_060_lesion_01.nii.gz,3,ct+seg+box,0.78,0.555,117,33,94,211.0,150
ULSDL3D_002965_02_01_060_lesion_01.nii.gz,5,ct+seg+2box,0.704,0.664,140,59,71,211.0,199
ULSDL3D_002965_02_01_060_lesion_01.nii.gz,6,ct+seg+mask,0.821,0.564,119,26,92,211.0,145
ULSDL3D_002965_02_01_060_lesion_01.nii.gz,7,ct+seg+2mask,0.944,0.872,184,11,27,211.0,195
ULSDL3D_002987_01_01_018_lesion_01.nii.gz,1,ct,0.8,0.8,124,31,31,155.0,155
ULSDL3D_002987_01_01_018_lesion_01.nii.gz,2,ct+seg,0.929,0.671,104,8,51,155.0,112
ULSDL3D_002987_01_01_018_lesion_01.nii.gz,3,ct+seg+box,0.98,0.639,99,2,56,155.0,101
ULSDL3D_002987_01_01_018_lesion_01.nii.gz,5,ct+seg+2box,0.766,0.865,134,41,21,155.0,175
ULSDL3D_002987_01_01_018_lesion_01.nii.gz,6,ct+seg+mask,0.98,0.632,98,2,57,155.0,100
ULSDL3D_002987_01_01_018_lesion_01.nii.gz,7,ct+seg+2mask,0.89,0.832,129,16,26,155.0,145
ULSDL3D_002987_02_01_083_lesion_01.nii.gz,1,ct,0.365,0.839,769,1340,148,917.0,2109
ULSDL3D_002987_02_01_083_lesion_01.nii.gz,2,ct+seg,0.884,0.559,513,67,404,917.0,580
ULSDL3D_002987_02_01_083_lesion_01.nii.gz,3,ct+seg+box,0.845,0.459,421,77,496,917.0,498
ULSDL3D_002987_02_01_083_lesion_01.nii.gz,5,ct+seg+2box,0.792,0.831,762,200,155,917.0,962
ULSDL3D_002987_02_01_083_lesion_01.nii.gz,6,ct+seg+mask,0.82,0.598,548,120,369,917.0,668
ULSDL3D_002987_02_01_083_lesion_01.nii.gz,7,ct+seg+2mask,0.857,0.747,685,114,232,917.0,799
ULSDL3D_003026_02_01_042_lesion_01.nii.gz,1,ct,0.062,0.3,76,1154,177,253.0,1230
ULSDL3D_003026_02_01_042_lesion_01.nii.gz,2,ct+seg,0.085,0.561,142,1532,111,253.0,1674
ULSDL3D_003026_02_01_042_lesion_01.nii.gz,3,ct+seg+box,0.938,0.538,136,9,117,253.0,145
ULSDL3D_003026_02_01_042_lesion_01.nii.gz,5,ct+seg+2box,0.917,0.652,165,15,88,253.0,180
ULSDL3D_003026_02_01_042_lesion_01.nii.gz,6,ct+seg+mask,0.969,0.49,124,4,129,253.0,128
ULSDL3D_003026_02_01_042_lesion_01.nii.gz,7,ct+seg+2mask,0.955,0.751,190,9,63,253.0,199
ULSDL3D_003185_06_03_142_lesion_01.nii.gz,1,ct,0.347,0.762,247,465,77,324.0,712
ULSDL3D_003185_06_03_142_lesion_01.nii.gz,2,ct+seg,0.975,0.472,153,4,171,324.0,157
ULSDL3D_003185_06_03_142_lesion_01.nii.gz,3,ct+seg+box,0.778,0.66,214,61,110,324.0,275
ULSDL3D_003185_06_03_142_lesion_01.nii.gz,5,ct+seg+2box,0.928,0.593,192,15,132,324.0,207
ULSDL3D_003185_06_03_142_lesion_01.nii.gz,6,ct+seg+mask,0.716,0.769,249,99,75,324.0,348
ULSDL3D_003185_06_03_142_lesion_01.nii.gz,7,ct+seg+2mask,0.965,0.593,192,7,132,324.0,199
ULSDL3D_003225_02_01_304_lesion_01.nii.gz,1,ct,0.745,0.287,403,138,1002,1405.0,541
ULSDL3D_003225_02_01_304_lesion_01.nii.gz,2,ct+seg,0.277,0.076,107,279,1298,1405.0,386
ULSDL3D_003225_02_01_304_lesion_01.nii.gz,3,ct+seg+box,0.0,0.0,0,0,1405,1405.0,0
ULSDL3D_003225_02_01_304_lesion_01.nii.gz,5,ct+seg+2box,0.655,0.738,1037,546,368,1405.0,1583
ULSDL3D_003225_02_01_304_lesion_01.nii.gz,6,ct+seg+mask,0.0,0.0,0,563,1405,1405.0,563
ULSDL3D_003225_02_01_304_lesion_01.nii.gz,7,ct+seg+2mask,0.563,0.833,1170,908,235,1405.0,2078
ULSDL3D_003230_01_01_184_lesion_01.nii.gz,1,ct,0.16,0.863,215,1127,34,249.0,1342
ULSDL3D_003230_01_01_184_lesion_01.nii.gz,2,ct+seg,0.851,0.755,188,33,61,249.0,221
ULSDL3D_003230_01_01_184_lesion_01.nii.gz,3,ct+seg+box,0.783,0.795,198,55,51,249.0,253
ULSDL3D_003230_01_01_184_lesion_01.nii.gz,5,ct+seg+2box,0.952,0.631,157,8,92,249.0,165
ULSDL3D_003230_01_01_184_lesion_01.nii.gz,6,ct+seg+mask,0.778,0.815,203,58,46,249.0,261
ULSDL3D_003230_01_01_184_lesion_01.nii.gz,7,ct+seg+2mask,0.966,0.57,142,5,107,249.0,147
ULSDL3D_003257_03_01_013_lesion_01.nii.gz,1,ct,0.0,0.0,0,1031,878,878.0,1031
ULSDL3D_003257_03_01_013_lesion_01.nii.gz,2,ct+seg,0.722,0.482,423,163,455,878.0,586
ULSDL3D_003257_03_01_013_lesion_01.nii.gz,3,ct+seg+box,0.898,0.22,193,22,685,878.0,215
ULSDL3D_003257_03_01_013_lesion_01.nii.gz,5,ct+seg+2box,0.774,0.747,656,192,222,878.0,848
ULSDL3D_003257_03_01_013_lesion_01.nii.gz,6,ct+seg+mask,0.9,0.246,216,24,662,878.0,240
ULSDL3D_003257_03_01_013_lesion_01.nii.gz,7,ct+seg+2mask,0.917,0.86,755,68,123,878.0,823
ULSDL3D_003287_01_01_188_lesion_01.nii.gz,1,ct,0.0,0.0,0,866,504,504.0,866
ULSDL3D_003287_01_01_188_lesion_01.nii.gz,2,ct+seg,0.0,0.0,0,233,504,504.0,233
ULSDL3D_003287_01_01_188_lesion_01.nii.gz,3,ct+seg+box,0.632,0.262,132,77,372,504.0,209
ULSDL3D_003287_01_01_188_lesion_01.nii.gz,5,ct+seg+2box,0.446,0.706,356,443,148,504.0,799
ULSDL3D_003287_01_01_188_lesion_01.nii.gz,6,ct+seg+mask,0.782,0.22,111,31,393,504.0,142
ULSDL3D_003287_01_01_188_lesion_01.nii.gz,7,ct+seg+2mask,0.886,0.635,320,41,184,504.0,361
ULSDL3D_003322_01_01_069_lesion_01.nii.gz,1,ct,0.761,0.71,235,74,96,331.0,309
ULSDL3D_003322_01_01_069_lesion_01.nii.gz,2,ct+seg,0.884,0.668,221,29,110,331.0,250
ULSDL3D_003322_01_01_069_lesion_01.nii.gz,3,ct+seg+box,0.927,0.616,204,16,127,331.0,220
ULSDL3D_003322_01_01_069_lesion_01.nii.gz,5,ct+seg+2box,0.68,0.776,257,121,74,331.0,378
ULSDL3D_003322_01_01_069_lesion_01.nii.gz,6,ct+seg+mask,0.95,0.574,190,10,141,331.0,200
ULSDL3D_003322_01_01_069_lesion_01.nii.gz,7,ct+seg+2mask,0.912,0.81,268,26,63,331.0,294
ULSDL3D_003398_01_01_030_lesion_01.nii.gz,1,ct,0.0,0.0,0,12,86,86.0,12
ULSDL3D_003398_01_01_030_lesion_01.nii.gz,2,ct+seg,0.107,0.419,36,299,50,86.0,335
ULSDL3D_003398_01_01_030_lesion_01.nii.gz,3,ct+seg+box,0.914,0.744,64,6,22,86.0,70
ULSDL3D_003398_01_01_030_lesion_01.nii.gz,5,ct+seg+2box,0.905,0.884,76,8,10,86.0,84
ULSDL3D_003398_01_01_030_lesion_01.nii.gz,6,ct+seg+mask,0.926,0.733,63,5,23,86.0,68
ULSDL3D_003398_01_01_030_lesion_01.nii.gz,7,ct+seg+2mask,0.875,0.977,84,12,2,86.0,96
ULSDL3D_003404_01_01_072_lesion_01.nii.gz,1,ct,0.0,0.0,0,1197,394,394.0,1197
ULSDL3D_003404_01_01_072_lesion_01.nii.gz,2,ct+seg,0.0,0.0,0,2996,394,394.0,2996
ULSDL3D_003404_01_01_072_lesion_01.nii.gz,3,ct+seg+box,0.862,0.632,249,40,145,394.0,289
ULSDL3D_003404_01_01_072_lesion_01.nii.gz,5,ct+seg+2box,0.785,0.863,340,93,54,394.0,433
ULSDL3D_003404_01_01_072_lesion_01.nii.gz,6,ct+seg+mask,0.958,0.576,227,10,167,394.0,237
ULSDL3D_003404_01_01_072_lesion_01.nii.gz,7,ct+seg+2mask,0.928,0.916,361,28,33,394.0,389
ULSDL3D_003407_01_02_372_lesion_01.nii.gz,1,ct,0.15,0.859,293,1655,48,341.0,1948
ULSDL3D_003407_01_02_372_lesion_01.nii.gz,2,ct+seg,0.981,0.592,202,4,139,341.0,206
ULSDL3D_003407_01_02_372_lesion_01.nii.gz,3,ct+seg+box,0.797,0.874,298,76,43,341.0,374
ULSDL3D_003407_01_02_372_lesion_01.nii.gz,5,ct+seg+2box,0.811,0.883,301,70,40,341.0,371
ULSDL3D_003407_01_02_372_lesion_01.nii.gz,6,ct+seg+mask,0.729,0.874,298,111,43,341.0,409
ULSDL3D_003407_01_02_372_lesion_01.nii.gz,7,ct+seg+2mask,0.964,0.704,240,9,101,341.0,249
ULSDL3D_003417_01_01_321_lesion_01.nii.gz,1,ct,0.0,0.0,0,2953,1000,1000.0,2953
ULSDL3D_003417_01_01_321_lesion_01.nii.gz,2,ct+seg,0.0,0.0,0,421,1000,1000.0,421
ULSDL3D_003417_01_01_321_lesion_01.nii.gz,3,ct+seg+box,0.0,0.0,0,0,1000,1000.0,0
ULSDL3D_003417_01_01_321_lesion_01.nii.gz,5,ct+seg+2box,0.699,0.756,756,325,244,1000.0,1081
ULSDL3D_003417_01_01_321_lesion_01.nii.gz,6,ct+seg+mask,0.0,0.0,0,1717,1000,1000.0,1717
ULSDL3D_003417_01_01_321_lesion_01.nii.gz,7,ct+seg+2mask,0.825,0.759,759,161,241,1000.0,920
ULSDL3D_003511_01_02_311_lesion_01.nii.gz,1,ct,0.184,0.508,248,1098,240,488.0,1346
ULSDL3D_003511_01_02_311_lesion_01.nii.gz,2,ct+seg,0.722,0.537,262,101,226,488.0,363
ULSDL3D_003511_01_02_311_lesion_01.nii.gz,3,ct+seg+box,0.878,0.617,301,42,187,488.0,343
ULSDL3D_003511_01_02_311_lesion_01.nii.gz,5,ct+seg+2box,0.843,0.768,375,70,113,488.0,445
ULSDL3D_003511_01_02_311_lesion_01.nii.gz,6,ct+seg+mask,0.944,0.557,272,16,216,488.0,288
ULSDL3D_003511_01_02_311_lesion_01.nii.gz,7,ct+seg+2mask,0.94,0.711,347,22,141,488.0,369
ULSDL3D_003516_03_02_185_lesion_01.nii.gz,1,ct,0.701,0.763,1049,447,326,1375.0,1496
ULSDL3D_003516_03_02_185_lesion_01.nii.gz,2,ct+seg,0.96,0.666,916,38,459,1375.0,954
ULSDL3D_003516_03_02_185_lesion_01.nii.gz,3,ct+seg+box,0.856,0.61,839,141,536,1375.0,980
ULSDL3D_003516_03_02_185_lesion_01.nii.gz,5,ct+seg+2box,0.887,0.709,975,124,400,1375.0,1099
ULSDL3D_003516_03_02_185_lesion_01.nii.gz,6,ct+seg+mask,0.88,0.556,764,104,611,1375.0,868
ULSDL3D_003516_03_02_185_lesion_01.nii.gz,7,ct+seg+2mask,0.909,0.672,924,92,451,1375.0,1016
ULSDL3D_003663_02_02_343_lesion_01.nii.gz,1,ct,0.0,0.0,0,3348,789,789.0,3348
ULSDL3D_003663_02_02_343_lesion_01.nii.gz,2,ct+seg,0.0,0.0,0,65,789,789.0,65
ULSDL3D_003663_02_02_343_lesion_01.nii.gz,3,ct+seg+box,0.761,0.705,556,175,233,789.0,731
ULSDL3D_003663_02_02_343_lesion_01.nii.gz,5,ct+seg+2box,0.894,0.644,508,60,281,789.0,568
ULSDL3D_003663_02_02_343_lesion_01.nii.gz,6,ct+seg+mask,0.707,0.762,601,249,188,789.0,850
ULSDL3D_003663_02_02_343_lesion_01.nii.gz,7,ct+seg+2mask,0.945,0.608,480,28,309,789.0,508
ULSDL3D_003664_01_01_052_lesion_01.nii.gz,1,ct,0.0,0.0,0,0,103,103.0,0
ULSDL3D_003664_01_01_052_lesion_01.nii.gz,2,ct+seg,0.001,0.184,19,22920,84,103.0,22939
ULSDL3D_003664_01_01_052_lesion_01.nii.gz,3,ct+seg+box,0.831,0.524,54,11,49,103.0,65
ULSDL3D_003664_01_01_052_lesion_01.nii.gz,5,ct+seg+2box,0.886,0.903,93,12,10,103.0,105
ULSDL3D_003664_01_01_052_lesion_01.nii.gz,6,ct+seg+mask,0.888,0.689,71,9,32,103.0,80
ULSDL3D_003664_01_01_052_lesion_01.nii.gz,7,ct+seg+2mask,0.881,0.932,96,13,7,103.0,109
ULSDL3D_003682_02_02_507_lesion_01.nii.gz,1,ct,0.235,0.384,253,824,405,658.0,1077
ULSDL3D_003682_02_02_507_lesion_01.nii.gz,2,ct+seg,0.766,0.477,314,96,344,658.0,410
ULSDL3D_003682_02_02_507_lesion_01.nii.gz,3,ct+seg+box,0.596,0.41,270,183,388,658.0,453
ULSDL3D_003682_02_02_507_lesion_01.nii.gz,5,ct+seg+2box,0.761,0.687,452,142,206,658.0,594
ULSDL3D_003682_02_02_507_lesion_01.nii.gz,6,ct+seg+mask,0.561,0.429,282,221,376,658.0,503
ULSDL3D_003682_02_02_507_lesion_01.nii.gz,7,ct+seg+2mask,0.923,0.786,517,43,141,658.0,560
ULSDL3D_003736_01_01_108_lesion_01.nii.gz,1,ct,0.168,0.508,150,745,145,295.0,895
ULSDL3D_003736_01_01_108_lesion_01.nii.gz,2,ct+seg,0.0,0.0,0,425,295,295.0,425
ULSDL3D_003736_01_01_108_lesion_01.nii.gz,3,ct+seg+box,0.858,0.861,254,42,41,295.0,296
ULSDL3D_003736_01_01_108_lesion_01.nii.gz,5,ct+seg+2box,0.726,0.837,247,93,48,295.0,340
ULSDL3D_003736_01_01_108_lesion_01.nii.gz,6,ct+seg+mask,0.772,0.861,254,75,41,295.0,329
ULSDL3D_003736_01_01_108_lesion_01.nii.gz,7,ct+seg+2mask,0.967,0.688,203,7,92,295.0,210
ULSDL3D_003754_01_01_125_lesion_01.nii.gz,1,ct,0.0,0.0,0,2071,647,647.0,2071
ULSDL3D_003754_01_01_125_lesion_01.nii.gz,2,ct+seg,0.0,0.0,0,1564,647,647.0,1564
ULSDL3D_003754_01_01_125_lesion_01.nii.gz,3,ct+seg+box,0.0,0.0,0,0,647,647.0,0
ULSDL3D_003754_01_01_125_lesion_01.nii.gz,5,ct+seg+2box,0.756,0.733,474,153,173,647.0,627
ULSDL3D_003754_01_01_125_lesion_01.nii.gz,6,ct+seg+mask,0.0,0.0,0,1236,647,647.0,1236
ULSDL3D_003754_01_01_125_lesion_01.nii.gz,7,ct+seg+2mask,0.717,0.847,548,216,99,647.0,764
ULSDL3D_003823_04_01_221_lesion_01.nii.gz,1,ct,0.342,0.971,329,634,10,339.0,963
ULSDL3D_003823_04_01_221_lesion_01.nii.gz,2,ct+seg,0.641,0.953,323,181,16,339.0,504
ULSDL3D_003823_04_01_221_lesion_01.nii.gz,3,ct+seg+box,0.865,0.835,283,44,56,339.0,327
ULSDL3D_003823_04_01_221_lesion_01.nii.gz,5,ct+seg+2box,0.971,0.693,235,7,104,339.0,242
ULSDL3D_003823_04_01_221_lesion_01.nii.gz,6,ct+seg+mask,0.94,0.737,250,16,89,339.0,266
ULSDL3D_003823_04_01_221_lesion_01.nii.gz,7,ct+seg+2mask,0.969,0.637,216,7,123,339.0,223
ULSDL3D_003931_01_01_078_lesion_01.nii.gz,1,ct,0.0,0.0,0,1340,3301,3301.0,1340
ULSDL3D_003931_01_01_078_lesion_01.nii.gz,2,ct+seg,0.487,0.296,976,1030,2325,3301.0,2006
ULSDL3D_003931_01_01_078_lesion_01.nii.gz,3,ct+seg+box,0.792,0.707,2333,613,968,3301.0,2946
ULSDL3D_003931_01_01_078_lesion_01.nii.gz,5,ct+seg+2box,0.782,0.868,2864,797,437,3301.0,3661
ULSDL3D_003931_01_01_078_lesion_01.nii.gz,6,ct+seg+mask,0.961,0.464,1533,62,1768,3301.0,1595
ULSDL3D_003931_01_01_078_lesion_01.nii.gz,7,ct+seg+2mask,0.88,0.799,2639,359,662,3301.0,2998
ULSDL3D_003961_01_03_212_lesion_01.nii.gz,1,ct,0.364,0.486,520,908,550,1070.0,1428
ULSDL3D_003961_01_03_212_lesion_01.nii.gz,2,ct+seg,0.926,0.707,756,60,314,1070.0,816
ULSDL3D_003961_01_03_212_lesion_01.nii.gz,3,ct+seg+box,0.892,0.47,503,61,567,1070.0,564
ULSDL3D_003961_01_03_212_lesion_01.nii.gz,5,ct+seg+2box,0.882,0.704,753,101,317,1070.0,854
ULSDL3D_003961_01_03_212_lesion_01.nii.gz,6,ct+seg+mask,0.889,0.496,531,66,539,1070.0,597
ULSDL3D_003961_01_03_212_lesion_01.nii.gz,7,ct+seg+2mask,0.905,0.698,747,78,323,1070.0,825
ULSDL3D_004028_01_04_502_lesion_01.nii.gz,1,ct,0.0,0.0,0,1792,138,138.0,1792
ULSDL3D_004028_01_04_502_lesion_01.nii.gz,2,ct+seg,0.0,0.0,0,681,138,138.0,681
ULSDL3D_004028_01_04_502_lesion_01.nii.gz,3,ct+seg+box,0.752,0.616,85,28,53,138.0,113
ULSDL3D_004028_01_04_502_lesion_01.nii.gz,5,ct+seg+2box,0.883,0.601,83,11,55,138.0,94
ULSDL3D_004028_01_04_502_lesion_01.nii.gz,6,ct+seg+mask,0.832,0.645,89,18,49,138.0,107
ULSDL3D_004028_01_04_502_lesion_01.nii.gz,7,ct+seg+2mask,0.954,0.601,83,4,55,138.0,87
ULSDL3D_004030_01_01_480_lesion_01.nii.gz,1,ct,0.0,0.0,0,1780,411,411.0,1780
ULSDL3D_004030_01_01_480_lesion_01.nii.gz,2,ct+seg,0.156,0.745,306,1650,105,411.0,1956
ULSDL3D_004030_01_01_480_lesion_01.nii.gz,3,ct+seg+box,0.979,0.674,277,6,134,411.0,283
ULSDL3D_004030_01_01_480_lesion_01.nii.gz,5,ct+seg+2box,0.926,0.735,302,24,109,411.0,326
ULSDL3D_004030_01_01_480_lesion_01.nii.gz,6,ct+seg+mask,0.907,0.74,304,31,107,411.0,335
ULSDL3D_004030_01_01_480_lesion_01.nii.gz,7,ct+seg+2mask,0.966,0.754,310,11,101,411.0,321
ULSDL3D_004030_01_02_162_lesion_01.nii.gz,1,ct,0.132,0.702,231,1523,98,329.0,1754
ULSDL3D_004030_01_02_162_lesion_01.nii.gz,2,ct+seg,0.975,0.471,155,4,174,329.0,159
ULSDL3D_004030_01_02_162_lesion_01.nii.gz,3,ct+seg+box,0.0,0.0,0,0,329,329.0,0
ULSDL3D_004030_01_02_162_lesion_01.nii.gz,5,ct+seg+2box,0.982,0.657,216,4,113,329.0,220
ULSDL3D_004030_01_02_162_lesion_01.nii.gz,6,ct+seg+mask,0.0,0.0,0,707,329,329.0,707
ULSDL3D_004030_01_02_162_lesion_01.nii.gz,7,ct+seg+2mask,0.987,0.702,231,3,98,329.0,234
ULSDL3D_004083_01_02_509_lesion_01.nii.gz,1,ct,0.164,0.776,325,1652,94,419.0,1977
ULSDL3D_004083_01_02_509_lesion_01.nii.gz,2,ct+seg,0.437,0.551,231,298,188,419.0,529
ULSDL3D_004083_01_02_509_lesion_01.nii.gz,3,ct+seg+box,0.0,0.0,0,0,419,419.0,0
ULSDL3D_004083_01_02_509_lesion_01.nii.gz,5,ct+seg+2box,0.765,0.721,302,93,117,419.0,395
ULSDL3D_004083_01_02_509_lesion_01.nii.gz,6,ct+seg+mask,0.594,0.649,272,186,147,419.0,458
ULSDL3D_004083_01_02_509_lesion_01.nii.gz,7,ct+seg+2mask,0.95,0.592,248,13,171,419.0,261
ULSDL3D_004161_01_03_017_lesion_01.nii.gz,1,ct,0.0,0.0,0,1295,150,150.0,1295
ULSDL3D_004161_01_03_017_lesion_01.nii.gz,2,ct+seg,0.232,0.773,116,385,34,150.0,501
ULSDL3D_004161_01_03_017_lesion_01.nii.gz,3,ct+seg+box,0.631,0.833,125,73,25,150.0,198
ULSDL3D_004161_01_03_017_lesion_01.nii.gz,5,ct+seg+2box,0.711,0.933,140,57,10,150.0,197
ULSDL3D_004161_01_03_017_lesion_01.nii.gz,6,ct+seg+mask,0.762,0.833,125,39,25,150.0,164
ULSDL3D_004161_01_03_017_lesion_01.nii.gz,7,ct+seg+2mask,0.899,0.953,143,16,7,150.0,159
ULSDL3D_004311_01_02_304_lesion_01.nii.gz,1,ct,0.0,0.0,0,2426,210,210.0,2426
ULSDL3D_004311_01_02_304_lesion_01.nii.gz,2,ct+seg,0.65,0.69,145,78,65,210.0,223
ULSDL3D_004311_01_02_304_lesion_01.nii.gz,3,ct+seg+box,0.0,0.0,0,0,210,210.0,0
ULSDL3D_004311_01_02_304_lesion_01.nii.gz,5,ct+seg+2box,0.839,0.619,130,25,80,210.0,155
ULSDL3D_004311_01_02_304_lesion_01.nii.gz,6,ct+seg+mask,0.0,0.0,0,1298,210,210.0,1298
ULSDL3D_004311_01_02_304_lesion_01.nii.gz,7,ct+seg+2mask,0.824,0.557,117,25,93,210.0,142
ULSDL3D_004315_01_01_304_lesion_01.nii.gz,1,ct,0.0,0.0,0,880,1042,1042.0,880
ULSDL3D_004315_01_01_304_lesion_01.nii.gz,2,ct+seg,0.519,0.695,724,671,318,1042.0,1395
ULSDL3D_004315_01_01_304_lesion_01.nii.gz,3,ct+seg+box,0.697,0.523,545,237,497,1042.0,782
ULSDL3D_004315_01_01_304_lesion_01.nii.gz,5,ct+seg+2box,0.734,0.679,707,256,335,1042.0,963
ULSDL3D_004315_01_01_304_lesion_01.nii.gz,6,ct+seg+mask,0.84,0.484,504,96,538,1042.0,600
ULSDL3D_004315_01_01_304_lesion_01.nii.gz,7,ct+seg+2mask,0.899,0.701,730,82,312,1042.0,812
ULSDL3D_004363_01_01_206_lesion_01.nii.gz,1,ct,0.0,0.0,0,1554,5630,5630.0,1554
ULSDL3D_004363_01_01_206_lesion_01.nii.gz,2,ct+seg,0.0,0.0,0,908,5630,5630.0,908
ULSDL3D_004363_01_01_206_lesion_01.nii.gz,3,ct+seg+box,0.903,0.48,2704,292,2926,5630.0,2996
ULSDL3D_004363_01_01_206_lesion_01.nii.gz,5,ct+seg+2box,0.935,0.736,4143,286,1487,5630.0,4429
ULSDL3D_004363_01_01_206_lesion_01.nii.gz,6,ct+seg+mask,0.942,0.439,2469,151,3161,5630.0,2620
ULSDL3D_004363_01_01_206_lesion_01.nii.gz,7,ct+seg+2mask,0.95,0.807,4542,238,1088,5630.0,4780
ULSDL3D_004383_01_02_309_lesion_01.nii.gz,1,ct,0.0,0.0,0,2189,3033,3033.0,2189
ULSDL3D_004383_01_02_309_lesion_01.nii.gz,2,ct+seg,0.0,0.0,0,661,3033,3033.0,661
ULSDL3D_004383_01_02_309_lesion_01.nii.gz,3,ct+seg+box,0.674,0.862,2613,1261,420,3033.0,3874
ULSDL3D_004383_01_02_309_lesion_01.nii.gz,5,ct+seg+2box,0.783,0.864,2621,727,412,3033.0,3348
ULSDL3D_004383_01_02_309_lesion_01.nii.gz,6,ct+seg+mask,0.842,0.713,2163,405,870,3033.0,2568
ULSDL3D_004383_01_02_309_lesion_01.nii.gz,7,ct+seg+2mask,0.915,0.836,2535,237,498,3033.0,2772
